,TestGesamt,MeldeDatum,FZHosp,FZICU,FZHospFree,FZICUFree,BundeslandID,Bundesland,Hospitalizations_total,ICU_capacity,ICU_perc
0,0,2020-04-01,7,3,12,3,1,Burgenland,10,6,50.0
1,0,2020-04-01,18,11,1048,119,2,Kärnten,29,130,8.5
2,9395,2020-04-01,164,36,3854,157,3,Niederösterreich,200,193,18.7
3,0,2020-04-01,113,29,4408,116,4,Oberösterreich,142,145,20.0
4,7439,2020-04-01,56,10,1267,85,5,Salzburg,66,95,10.5
5,0,2020-04-01,138,27,2924,162,6,Steiermark,165,189,14.3
6,0,2020-04-01,156,57,700,102,7,Tirol,213,159,35.8
7,0,2020-04-01,39,12,500,84,8,Vorarlberg,51,96,12.5
8,0,2020-04-01,165,30,0,0,9,Wien,195,30,100.0
9,16834,2020-04-01,856,215,14713,828,10,Alle,1071,1043,20.6
10,1265,2020-04-02,10,3,530,37,1,Burgenland,13,40,7.5
11,4078,2020-04-02,17,1,728,75,2,Kärnten,18,76,1.3
12,9982,2020-04-02,160,43,3842,127,3,Niederösterreich,203,170,25.3
13,15740,2020-04-02,107,31,4421,137,4,Oberösterreich,138,168,18.5
14,8046,2020-04-02,52,13,1441,82,5,Salzburg,65,95,13.7
15,9127,2020-04-02,121,28,2941,151,6,Steiermark,149,179,15.6
16,21051,2020-04-02,159,56,728,105,7,Tirol,215,161,34.8
17,4021,2020-04-02,39,12,500,33,8,Vorarlberg,51,45,26.7
18,18880,2020-04-02,158,32,0,0,9,Wien,190,32,100.0
19,92190,2020-04-02,823,219,15131,747,10,Alle,1042,966,22.7
20,1375,2020-04-03,8,4,497,22,1,Burgenland,12,26,15.4
21,4303,2020-04-03,17,11,737,80,2,Kärnten,28,91,12.1
22,10566,2020-04-03,160,43,3842,127,3,Niederösterreich,203,170,25.3
23,17287,2020-04-03,102,33,4496,101,4,Oberösterreich,135,134,24.6
24,8783,2020-04-03,59,14,1330,81,5,Salzburg,73,95,14.7
25,9694,2020-04-03,134,30,2956,151,6,Steiermark,164,181,16.6
26,22328,2020-04-03,154,55,740,106,7,Tirol,209,161,34.2
27,4389,2020-04-03,39,12,481,27,8,Vorarlberg,51,39,30.8
28,19618,2020-04-03,156,43,0,0,9,Wien,199,43,100.0
29,98343,2020-04-03,829,245,15079,695,10,Alle,1074,940,26.1
30,1486,2020-04-04,7,3,528,23,1,Burgenland,10,26,11.5
31,4509,2020-04-04,21,11,730,82,2,Kärnten,32,93,11.8
32,11086,2020-04-04,167,39,3937,131,3,Niederösterreich,206,170,22.9
33,18643,2020-04-04,102,33,4496,101,4,Oberösterreich,135,134,24.6
34,9361,2020-04-04,64,15,1325,80,5,Salzburg,79,95,15.8
35,10262,2020-04-04,126,34,3035,163,6,Steiermark,160,197,17.3
36,23246,2020-04-04,156,54,740,117,7,Tirol,210,171,31.6
37,4801,2020-04-04,35,12,485,27,8,Vorarlberg,47,39,30.8
38,20740,2020-04-04,148,44,0,0,9,Wien,192,44,100.0
39,104134,2020-04-04,826,245,15276,724,10,Alle,1071,969,25.3
40,1495,2020-04-05,6,6,521,25,1,Burgenland,12,31,19.4
41,4601,2020-04-05,22,13,721,80,2,Kärnten,35,93,14.0
42,11397,2020-04-05,69,43,4012,127,3,Niederösterreich,112,170,25.3
43,19496,2020-04-05,104,32,4765,103,4,Oberösterreich,136,135,23.7
44,9641,2020-04-05,76,14,1330,81,5,Salzburg,90,95,14.7
45,10715,2020-04-05,110,28,3159,154,6,Steiermark,138,182,15.4
46,23962,2020-04-05,142,54,747,115,7,Tirol,196,169,32.0
47,4965,2020-04-05,33,12,485,83,8,Vorarlberg,45,95,12.6
48,22144,2020-04-05,150,42,0,0,9,Wien,192,42,100.0
49,108416,2020-04-05,712,244,15740,768,10,Alle,956,1012,24.1
50,1521,2020-04-06,5,6,531,16,1,Burgenland,11,22,27.3
51,4682,2020-04-06,22,12,726,75,2,Kärnten,34,87,13.8
52,11829,2020-04-06,164,43,4276,127,3,Niederösterreich,207,170,25.3
53,20041,2020-04-06,106,29,4619,100,4,Oberösterreich,135,129,22.5
54,9799,2020-04-06,72,18,1451,97,5,Salzburg,90,115,15.7
55,11049,2020-04-06,125,30,3124,164,6,Steiermark,155,194,15.5
56,24412,2020-04-06,141,59,795,114,7,Tirol,200,173,34.1
57,5165,2020-04-06,32,11,489,82,8,Vorarlberg,43,93,11.8
58,22798,2020-04-06,157,42,0,0,9,Wien,199,42,100.0
59,111296,2020-04-06,824,250,16011,775,10,Alle,1074,1025,24.4
60,1639,2020-04-07,9,4,546,15,1,Burgenland,13,19,21.1
61,4895,2020-04-07,23,12,727,76,2,Kärnten,35,88,13.6
62,12393,2020-04-07,169,48,4255,122,3,Niederösterreich,217,170,28.2
63,20853,2020-04-07,94,31,4440,93,4,Oberösterreich,125,124,25.0
64,9978,2020-04-07,79,16,1444,99,5,Salzburg,95,115,13.9
65,11522,2020-04-07,137,29,2988,159,6,Steiermark,166,188,15.4
66,25061,2020-04-07,156,59,746,105,7,Tirol,215,164,36.0
67,5235,2020-04-07,32,11,489,29,8,Vorarlberg,43,40,27.5
68,23659,2020-04-07,158,33,3301,239,9,Wien,191,272,12.1
69,115235,2020-04-07,857,243,18936,937,10,Alle,1100,1180,20.6
70,1609,2020-04-08,10,2,553,14,1,Burgenland,12,16,12.5
71,5199,2020-04-08,21,12,729,83,2,Kärnten,33,95,12.6
72,12911,2020-04-08,153,55,3724,115,3,Niederösterreich,208,170,32.4
73,21846,2020-04-08,119,33,4357,91,4,Oberösterreich,152,124,26.6
74,10605,2020-04-08,69,21,1454,94,5,Salzburg,90,115,18.3
75,12184,2020-04-08,143,33,2915,155,6,Steiermark,176,188,17.6
76,26141,2020-04-08,132,65,758,113,7,Tirol,197,178,36.5
77,5391,2020-04-08,29,11,492,28,8,Vorarlberg,40,39,28.2
78,24869,2020-04-08,153,35,3575,295,9,Wien,188,330,10.6
79,120755,2020-04-08,829,267,18557,988,10,Alle,1096,1255,21.3
80,1667,2020-04-09,11,4,567,12,1,Burgenland,15,16,25.0
81,5573,2020-04-09,19,13,728,86,2,Kärnten,32,99,13.1
82,13457,2020-04-09,154,54,3659,116,3,Niederösterreich,208,170,31.8
83,22839,2020-04-09,117,29,4327,104,4,Oberösterreich,146,133,21.8
84,11101,2020-04-09,75,19,1448,92,5,Salzburg,94,111,17.1
85,12753,2020-04-09,141,31,2768,144,6,Steiermark,172,175,17.7
86,27174,2020-04-09,123,65,747,104,7,Tirol,188,169,38.5
87,5609,2020-04-09,29,11,492,81,8,Vorarlberg,40,92,12.0
88,26114,2020-04-09,151,40,3664,269,9,Wien,191,309,12.9
89,126287,2020-04-09,820,266,18400,1008,10,Alle,1086,1274,20.9
90,1736,2020-04-10,8,4,648,13,1,Burgenland,12,17,23.5
91,5891,2020-04-10,18,12,730,84,2,Kärnten,30,96,12.5
92,14061,2020-04-10,152,53,3616,117,3,Niederösterreich,205,170,31.2
93,23638,2020-04-10,92,28,4406,97,4,Oberösterreich,120,125,22.4
94,11521,2020-04-10,74,19,1449,92,5,Salzburg,93,111,17.1
95,13390,2020-04-10,131,32,2782,141,6,Steiermark,163,173,18.5
96,30904,2020-04-10,122,61,712,95,7,Tirol,183,156,39.1
97,5958,2020-04-10,27,11,494,80,8,Vorarlberg,38,91,12.1
98,27644,2020-04-10,147,41,3681,268,9,Wien,188,309,13.3
99,134743,2020-04-10,771,261,18518,987,10,Alle,1032,1248,20.9
100,1768,2020-04-11,11,3,573,12,1,Burgenland,14,15,20.0
101,6082,2020-04-11,19,10,729,83,2,Kärnten,29,93,10.8
102,14544,2020-04-11,194,42,3616,117,3,Niederösterreich,236,159,26.4
103,24818,2020-04-11,87,29,4718,97,4,Oberösterreich,116,126,23.0
104,11864,2020-04-11,70,18,1453,93,5,Salzburg,88,111,16.2
105,13954,2020-04-11,116,33,2800,127,6,Steiermark,149,160,20.6
106,32951,2020-04-11,116,63,692,91,7,Tirol,179,154,40.9
107,6082,2020-04-11,27,10,495,27,8,Vorarlberg,37,37,27.0
108,28912,2020-04-11,150,37,3838,223,9,Wien,187,260,14.2
109,140975,2020-04-11,790,245,18914,870,10,Alle,1035,1115,22.0
110,1799,2020-04-12,14,3,577,13,1,Burgenland,17,16,18.8
111,6156,2020-04-12,17,10,726,84,2,Kärnten,27,94,10.6
112,15267,2020-04-12,189,42,3616,117,3,Niederösterreich,231,159,26.4
113,25257,2020-04-12,86,29,4837,105,4,Oberösterreich,115,134,21.6
114,12215,2020-04-12,68,21,1455,90,5,Salzburg,89,111,18.9
115,14430,2020-04-12,122,32,2939,139,6,Steiermark,154,171,18.7
116,33473,2020-04-12,113,61,422,99,7,Tirol,174,160,38.1
117,6355,2020-04-12,27,10,495,27,8,Vorarlberg,37,37,27.0
118,29925,2020-04-12,156,35,3673,206,9,Wien,191,241,14.5
119,144877,2020-04-12,792,243,18740,880,10,Alle,1035,1123,21.6
120,1823,2020-04-13,9,3,551,13,1,Burgenland,12,16,18.8
121,6250,2020-04-13,17,10,719,88,2,Kärnten,27,98,10.2
122,15483,2020-04-13,192,42,4104,146,3,Niederösterreich,234,188,22.3
123,25482,2020-04-13,84,32,4787,99,4,Oberösterreich,116,131,24.4
124,12450,2020-04-13,71,20,1452,91,5,Salzburg,91,111,18.0
125,14994,2020-04-13,115,31,2963,141,6,Steiermark,146,172,18.0
126,35005,2020-04-13,103,57,434,103,7,Tirol,160,160,35.6
127,6464,2020-04-13,22,10,500,83,8,Vorarlberg,32,93,10.8
128,30461,2020-04-13,129,34,3876,224,9,Wien,163,258,13.2
129,148412,2020-04-13,742,239,19386,988,10,Alle,981,1227,19.5
130,1849,2020-04-14,11,4,534,11,1,Burgenland,15,15,26.7
131,6365,2020-04-14,16,8,728,79,2,Kärnten,24,87,9.2
132,15860,2020-04-14,193,43,4156,147,3,Niederösterreich,236,190,22.6
133,26023,2020-04-14,86,30,4520,99,4,Oberösterreich,116,129,23.3
134,12590,2020-04-14,81,20,1442,91,5,Salzburg,101,111,18.0
135,15558,2020-04-14,113,28,2861,144,6,Steiermark,141,172,16.3
136,35629,2020-04-14,104,56,440,107,7,Tirol,160,163,34.4
137,6531,2020-04-14,23,10,499,83,8,Vorarlberg,33,93,10.8
138,31391,2020-04-14,132,44,3868,221,9,Wien,176,265,16.6
139,151796,2020-04-14,759,243,19048,982,10,Alle,1002,1225,19.8
140,1938,2020-04-15,16,4,547,12,1,Burgenland,20,16,25.0
141,6549,2020-04-15,15,10,733,82,2,Kärnten,25,92,10.9
142,16188,2020-04-15,193,42,4156,147,3,Niederösterreich,235,189,22.2
143,26579,2020-04-15,87,30,4153,104,4,Oberösterreich,117,134,22.4
144,12837,2020-04-15,78,19,1445,92,5,Salzburg,97,111,17.1
145,16225,2020-04-15,118,24,2655,135,6,Steiermark,142,159,15.1
146,37091,2020-04-15,109,55,423,102,7,Tirol,164,157,35.0
147,6734,2020-04-15,23,10,499,31,8,Vorarlberg,33,41,24.4
148,32660,2020-04-15,130,38,3782,225,9,Wien,168,263,14.4
149,156801,2020-04-15,769,232,18393,930,10,Alle,1001,1162,20.0
150,2020,2020-04-16,13,4,493,18,1,Burgenland,17,22,18.2
151,6887,2020-04-16,13,10,737,87,2,Kärnten,23,97,10.3
152,17410,2020-04-16,190,46,3896,137,3,Niederösterreich,236,183,25.1
153,27453,2020-04-16,78,31,4025,104,4,Oberösterreich,109,135,23.0
154,13288,2020-04-16,73,15,1450,96,5,Salzburg,88,111,13.5
155,16996,2020-04-16,120,21,2545,135,6,Steiermark,141,156,13.5
156,38388,2020-04-16,90,54,401,94,7,Tirol,144,148,36.5
157,6767,2020-04-16,18,11,503,25,8,Vorarlberg,29,36,30.6
158,33607,2020-04-16,134,46,3727,217,9,Wien,180,263,17.5
159,162816,2020-04-16,729,238,17777,913,10,Alle,967,1151,20.7
160,2209,2020-04-17,13,5,492,15,1,Burgenland,18,20,25.0
161,6956,2020-04-17,10,8,727,87,2,Kärnten,18,95,8.4
162,18269,2020-04-17,179,40,3896,137,3,Niederösterreich,219,177,22.6
163,27858,2020-04-17,71,30,3936,108,4,Oberösterreich,101,138,21.7
164,13659,2020-04-17,77,19,1446,92,5,Salzburg,96,111,17.1
165,17998,2020-04-17,112,22,2510,147,6,Steiermark,134,169,13.0
166,39722,2020-04-17,81,54,357,82,7,Tirol,135,136,39.7
167,6998,2020-04-17,13,10,509,77,8,Vorarlberg,23,87,11.5
168,35603,2020-04-17,126,39,3671,223,9,Wien,165,262,14.9
169,169272,2020-04-17,682,227,17544,968,10,Alle,909,1195,19.0
170,2301,2020-04-18,12,5,486,15,1,Burgenland,17,20,25.0
171,7156,2020-04-18,7,9,739,85,2,Kärnten,16,94,9.6
172,18831,2020-04-18,166,41,3896,137,3,Niederösterreich,207,178,23.0
173,29190,2020-04-18,72,25,4268,97,4,Oberösterreich,97,122,20.5
174,14085,2020-04-18,74,17,1449,94,5,Salzburg,91,111,15.3
175,19036,2020-04-18,98,20,2537,146,6,Steiermark,118,166,12.0
176,40884,2020-04-18,74,51,350,83,7,Tirol,125,134,38.1
177,7193,2020-04-18,15,8,509,79,8,Vorarlberg,23,87,9.2
178,37256,2020-04-18,129,32,3731,215,9,Wien,161,247,13.0
179,175932,2020-04-18,647,208,17965,951,10,Alle,855,1159,17.9
180,2357,2020-04-19,11,5,479,19,1,Burgenland,16,24,20.8
181,7269,2020-04-19,6,9,727,82,2,Kärnten,15,91,9.9
182,19112,2020-04-19,156,40,3896,137,3,Niederösterreich,196,177,22.6
183,29696,2020-04-19,66,29,4353,95,4,Oberösterreich,95,124,23.4
184,14386,2020-04-19,72,16,1451,125,5,Salzburg,88,141,11.3
185,19749,2020-04-19,99,18,2716,164,6,Steiermark,117,182,9.9
186,42019,2020-04-19,63,49,370,81,7,Tirol,112,130,37.7
187,7400,2020-04-19,12,7,513,24,8,Vorarlberg,19,31,22.6
188,37256,2020-04-19,128,31,3716,310,9,Wien,159,341,9.1
189,179244,2020-04-19,613,204,18221,1037,10,Alle,817,1241,16.4
190,2386,2020-04-20,12,4,468,18,1,Burgenland,16,22,18.2
191,7624,2020-04-20,6,9,739,79,2,Kärnten,15,88,10.2
192,19588,2020-04-20,156,37,3896,137,3,Niederösterreich,193,174,21.3
193,30373,2020-04-20,63,27,4188,93,4,Oberösterreich,90,120,22.5
194,14691,2020-04-20,75,17,1452,124,5,Salzburg,92,141,12.1
195,20098,2020-04-20,91,17,2683,144,6,Steiermark,108,161,10.6
196,42813,2020-04-20,70,44,349,87,7,Tirol,114,131,33.6
197,7626,2020-04-20,11,7,514,27,8,Vorarlberg,18,34,20.6
198,37750,2020-04-20,127,32,3794,248,9,Wien,159,280,11.4
199,182949,2020-04-20,611,194,18083,957,10,Alle,805,1151,16.9
200,2534,2020-04-21,13,4,472,16,1,Burgenland,17,20,20.0
201,7914,2020-04-21,8,9,717,81,2,Kärnten,17,90,10.0
202,20218,2020-04-21,109,42,3696,128,3,Niederösterreich,151,170,24.7
203,31046,2020-04-21,60,30,3809,90,4,Oberösterreich,90,120,25.0
204,14944,2020-04-21,79,15,1448,126,5,Salzburg,94,141,10.6
205,20792,2020-04-21,86,17,2469,140,6,Steiermark,103,157,10.8
206,43731,2020-04-21,67,44,353,96,7,Tirol,111,140,31.4
207,7959,2020-04-21,11,6,250,83,8,Vorarlberg,17,89,6.7
208,39880,2020-04-21,127,29,3415,225,9,Wien,156,254,11.4
209,189018,2020-04-21,560,196,16629,985,10,Alle,756,1181,16.6
210,2660,2020-04-22,10,2,461,16,1,Burgenland,12,18,11.1
211,8269,2020-04-22,7,7,720,75,2,Kärnten,14,82,8.5
212,20980,2020-04-22,98,43,3278,129,3,Niederösterreich,141,172,25.0
213,31933,2020-04-22,59,20,3698,88,4,Oberösterreich,79,108,18.5
214,15447,2020-04-22,92,13,1435,128,5,Salzburg,105,141,9.2
215,21678,2020-04-22,81,14,2398,140,6,Steiermark,95,154,9.1
216,44902,2020-04-22,56,40,302,97,7,Tirol,96,137,29.2
217,8384,2020-04-22,11,7,249,81,8,Vorarlberg,18,88,8.0
218,47541,2020-04-22,110,30,3433,321,9,Wien,140,351,8.5
219,201794,2020-04-22,524,176,15974,1075,10,Alle,700,1251,14.1
220,3006,2020-04-23,13,4,451,17,1,Burgenland,17,21,19.0
221,8528,2020-04-23,7,7,718,90,2,Kärnten,14,97,7.2
222,21969,2020-04-23,88,43,3157,132,3,Niederösterreich,131,175,24.6
223,33100,2020-04-23,60,18,3658,89,4,Oberösterreich,78,107,16.8
224,15969,2020-04-23,78,14,1527,141,5,Salzburg,92,155,9.0
225,22738,2020-04-23,83,16,2364,143,6,Steiermark,99,159,10.1
226,46349,2020-04-23,53,38,318,96,7,Tirol,91,134,28.4
227,8656,2020-04-23,10,6,251,27,8,Vorarlberg,16,33,18.2
228,45520,2020-04-23,116,23,3373,250,9,Wien,139,273,8.4
229,205835,2020-04-23,508,169,15817,985,10,Alle,677,1154,14.6
230,3568,2020-04-24,12,2,433,18,1,Burgenland,14,20,10.0
231,8755,2020-04-24,7,7,717,82,2,Kärnten,14,89,7.9
232,22572,2020-04-24,87,40,3184,133,3,Niederösterreich,127,173,23.1
233,34014,2020-04-24,63,15,3640,97,4,Oberösterreich,78,112,13.4
234,16674,2020-04-24,78,12,1449,129,5,Salzburg,90,141,8.5
235,23673,2020-04-24,75,13,2386,132,6,Steiermark,88,145,9.0
236,47235,2020-04-24,45,36,317,100,7,Tirol,81,136,26.5
237,8989,2020-04-24,8,6,253,27,8,Vorarlberg,14,33,18.2
238,47206,2020-04-24,120,25,3489,339,9,Wien,145,364,6.9
239,212686,2020-04-24,495,156,15868,1057,10,Alle,651,1213,12.9
240,4155,2020-04-25,10,2,463,19,1,Burgenland,12,21,9.5
241,8947,2020-04-25,6,7,725,75,2,Kärnten,13,82,8.5
242,24800,2020-04-25,77,37,3207,133,3,Niederösterreich,114,170,21.8
243,34849,2020-04-25,56,15,3941,98,4,Oberösterreich,71,113,13.3
244,17293,2020-04-25,71,12,1456,129,5,Salzburg,83,141,8.5
245,24949,2020-04-25,65,12,2416,135,6,Steiermark,77,147,8.2
246,48093,2020-04-25,43,34,335,90,7,Tirol,77,124,27.4
247,9396,2020-04-25,6,6,255,26,8,Vorarlberg,12,32,18.8
248,48607,2020-04-25,126,23,3536,347,9,Wien,149,370,6.2
249,221089,2020-04-25,460,148,16334,1052,10,Alle,608,1200,12.3
250,4167,2020-04-26,9,2,477,17,1,Burgenland,11,19,10.5
251,9036,2020-04-26,6,6,717,81,2,Kärnten,12,87,6.9
252,25849,2020-04-26,81,39,3178,131,3,Niederösterreich,120,170,22.9
253,35501,2020-04-26,53,14,3994,105,4,Oberösterreich,67,119,11.8
254,18171,2020-04-26,68,11,1459,130,5,Salzburg,79,141,7.8
255,25666,2020-04-26,64,12,2612,125,6,Steiermark,76,137,8.8
256,48412,2020-04-26,43,32,304,94,7,Tirol,75,126,25.4
257,9856,2020-04-26,6,6,255,26,8,Vorarlberg,12,32,18.8
258,50973,2020-04-26,119,23,3645,363,9,Wien,142,386,6.0
259,227631,2020-04-26,449,145,16641,1072,10,Alle,594,1217,11.9
260,4232,2020-04-27,11,2,461,15,1,Burgenland,13,17,11.8
261,9119,2020-04-27,6,6,715,76,2,Kärnten,12,82,7.3
262,27250,2020-04-27,76,37,3505,133,3,Niederösterreich,113,170,21.8
263,36230,2020-04-27,55,11,3779,114,4,Oberösterreich,66,125,8.8
264,18883,2020-04-27,63,11,1464,130,5,Salzburg,74,141,7.8
265,26126,2020-04-27,63,12,2541,134,6,Steiermark,75,146,8.2
266,48674,2020-04-27,41,33,305,97,7,Tirol,74,130,25.4
267,10219,2020-04-27,6,5,256,25,8,Vorarlberg,11,30,16.7
268,51804,2020-04-27,118,23,3637,349,9,Wien,141,372,6.2
269,232537,2020-04-27,439,140,16663,1073,10,Alle,579,1213,11.5
270,5302,2020-04-28,8,3,457,14,1,Burgenland,11,17,17.6
271,9471,2020-04-28,5,6,728,86,2,Kärnten,11,92,6.5
272,28534,2020-04-28,75,35,3540,135,3,Niederösterreich,110,170,20.6
273,37146,2020-04-28,46,14,3535,90,4,Oberösterreich,60,104,13.5
274,19348,2020-04-28,65,10,1462,131,5,Salzburg,75,141,7.1
275,26908,2020-04-28,64,10,2349,137,6,Steiermark,74,147,6.8
276,49393,2020-04-28,40,32,294,98,7,Tirol,72,130,24.6
277,10362,2020-04-28,6,5,256,24,8,Vorarlberg,11,29,17.2
278,53114,2020-04-28,116,21,3443,340,9,Wien,137,361,5.8
279,239578,2020-04-28,425,136,16064,1055,10,Alle,561,1191,11.4
280,5971,2020-04-29,6,2,435,14,1,Burgenland,8,16,12.5
281,9648,2020-04-29,5,5,725,82,2,Kärnten,10,87,5.7
282,29741,2020-04-29,68,36,3056,134,3,Niederösterreich,104,170,21.2
283,38144,2020-04-29,39,12,3413,92,4,Oberösterreich,51,104,11.5
284,20210,2020-04-29,63,10,1464,131,5,Salzburg,73,141,7.1
285,27813,2020-04-29,57,12,2301,133,6,Steiermark,69,145,8.3
286,50269,2020-04-29,34,28,317,91,7,Tirol,62,119,23.5
287,10811,2020-04-29,4,5,258,24,8,Vorarlberg,9,29,17.2
288,55147,2020-04-29,110,21,3289,317,9,Wien,131,338,6.2
289,247754,2020-04-29,386,131,15258,1018,10,Alle,517,1149,11.4
290,6619,2020-04-30,7,2,432,15,1,Burgenland,9,17,11.8
291,9904,2020-04-30,3,5,730,89,2,Kärnten,8,94,5.3
292,31034,2020-04-30,66,36,2952,134,3,Niederösterreich,102,170,21.2
293,39188,2020-04-30,33,12,3499,94,4,Oberösterreich,45,106,11.3
294,21585,2020-04-30,64,9,1463,132,5,Salzburg,73,141,6.4
295,28844,2020-04-30,57,10,2240,124,6,Steiermark,67,134,7.5
296,51310,2020-04-30,32,28,315,97,7,Tirol,60,125,22.4
297,11165,2020-04-30,2,5,260,23,8,Vorarlberg,7,28,17.9
298,56750,2020-04-30,108,21,3190,304,9,Wien,129,325,6.5
299,256399,2020-04-30,372,128,15081,1012,10,Alle,500,1140,11.2
300,6959,2020-05-01,6,2,463,12,1,Burgenland,8,14,14.3
301,10152,2020-05-01,3,5,727,87,2,Kärnten,8,92,5.4
302,31930,2020-05-01,62,37,2950,133,3,Niederösterreich,99,170,21.8
303,40001,2020-05-01,34,10,3884,87,4,Oberösterreich,44,97,10.3
304,22422,2020-05-01,62,7,1465,134,5,Salzburg,69,141,5.0
305,29979,2020-05-01,51,10,2215,126,6,Steiermark,61,136,7.4
306,52504,2020-05-01,25,27,321,79,7,Tirol,52,106,25.5
307,11719,2020-05-01,3,4,260,19,8,Vorarlberg,7,23,17.4
308,58413,2020-05-01,102,22,3918,331,9,Wien,124,353,6.2
309,264079,2020-05-01,348,124,16203,1008,10,Alle,472,1132,11.0
310,7426,2020-05-02,6,2,475,12,1,Burgenland,8,14,14.3
311,10302,2020-05-02,3,4,725,81,2,Kärnten,7,85,4.7
312,32438,2020-05-02,55,35,2990,135,3,Niederösterreich,90,170,20.6
313,40747,2020-05-02,34,8,4094,103,4,Oberösterreich,42,111,7.2
314,23075,2020-05-02,45,7,1482,134,5,Salzburg,52,141,5.0
315,30866,2020-05-02,43,9,2450,131,6,Steiermark,52,140,6.4
316,52934,2020-05-02,24,24,253,83,7,Tirol,48,107,22.4
317,12374,2020-05-02,3,4,260,24,8,Vorarlberg,7,28,14.3
318,59457,2020-05-02,101,21,4085,343,9,Wien,122,364,5.8
319,269619,2020-05-02,314,114,16814,1046,10,Alle,428,1160,9.8
320,7529,2020-05-03,3,1,470,15,1,Burgenland,4,16,6.2
321,10519,2020-05-03,3,3,729,83,2,Kärnten,6,86,3.5
322,32815,2020-05-03,51,34,3456,136,3,Niederösterreich,85,170,20.0
323,41188,2020-05-03,39,9,4138,97,4,Oberösterreich,48,106,8.5
324,24102,2020-05-03,44,7,1483,134,5,Salzburg,51,141,5.0
325,31215,2020-05-03,38,9,2522,137,6,Steiermark,47,146,6.2
326,53261,2020-05-03,25,25,249,90,7,Tirol,50,115,21.7
327,12783,2020-05-03,3,4,260,27,8,Vorarlberg,7,31,12.9
328,60943,2020-05-03,102,22,3785,336,9,Wien,124,358,6.1
329,274355,2020-05-03,308,114,17092,1055,10,Alle,422,1169,9.8
330,7637,2020-05-04,2,1,456,18,1,Burgenland,3,19,5.3
331,10837,2020-05-04,3,3,715,87,2,Kärnten,6,90,3.3
332,33646,2020-05-04,51,35,3539,135,3,Niederösterreich,86,170,20.6
333,41843,2020-05-04,32,8,3827,102,4,Oberösterreich,40,110,7.3
334,24613,2020-05-04,53,7,1474,134,5,Salzburg,60,141,5.0
335,31579,2020-05-04,34,9,2455,130,6,Steiermark,43,139,6.5
336,53512,2020-05-04,24,25,255,90,7,Tirol,49,115,21.7
337,13040,2020-05-04,3,4,260,27,8,Vorarlberg,7,31,12.9
338,62364,2020-05-04,107,19,3998,333,9,Wien,126,352,5.4
339,279071,2020-05-04,309,111,16979,1056,10,Alle,420,1167,9.5
340,7795,2020-05-05,5,1,442,15,1,Burgenland,6,16,6.2
341,11029,2020-05-05,3,2,718,90,2,Kärnten,5,92,2.2
342,34690,2020-05-05,53,33,3445,137,3,Niederösterreich,86,170,19.4
343,42706,2020-05-05,33,7,3248,95,4,Oberösterreich,40,102,6.9
344,25216,2020-05-05,46,7,1481,134,5,Salzburg,53,141,5.0
345,32158,2020-05-05,32,9,2192,122,6,Steiermark,41,131,6.9
346,54720,2020-05-05,22,21,252,96,7,Tirol,43,117,17.9
347,13156,2020-05-05,4,4,259,28,8,Vorarlberg,8,32,12.5
348,64413,2020-05-05,116,20,3603,325,9,Wien,136,345,5.8
349,285883,2020-05-05,314,104,15640,1042,10,Alle,418,1146,9.1
350,7847,2020-05-06,4,1,418,12,1,Burgenland,5,13,7.7
351,11483,2020-05-06,2,3,727,85,2,Kärnten,5,88,3.4
352,35997,2020-05-06,55,29,2926,141,3,Niederösterreich,84,170,17.1
353,43698,2020-05-06,30,6,3067,96,4,Oberösterreich,36,102,5.9
354,24790,2020-05-06,52,7,1272,134,5,Salzburg,59,141,5.0
355,33003,2020-05-06,32,8,2042,109,6,Steiermark,40,117,6.8
356,55574,2020-05-06,18,19,240,90,7,Tirol,37,109,17.4
357,13324,2020-05-06,3,4,260,22,8,Vorarlberg,7,26,15.4
358,66538,2020-05-06,125,20,3335,315,9,Wien,145,335,6.0
359,292254,2020-05-06,321,97,14287,1004,10,Alle,418,1101,8.8
360,8078,2020-05-07,3,1,427,17,1,Burgenland,4,18,5.6
361,11647,2020-05-07,2,3,731,85,2,Kärnten,5,88,3.4
362,37010,2020-05-07,48,28,2807,142,3,Niederösterreich,76,170,16.5
363,44417,2020-05-07,25,7,3108,88,4,Oberösterreich,32,95,7.4
364,25320,2020-05-07,51,7,1273,134,5,Salzburg,58,141,5.0
365,33702,2020-05-07,31,7,1983,120,6,Steiermark,38,127,5.5
366,56188,2020-05-07,13,17,243,92,7,Tirol,30,109,15.6
367,13794,2020-05-07,3,3,260,21,8,Vorarlberg,6,24,12.5
368,67738,2020-05-07,92,19,3233,311,9,Wien,111,330,5.8
369,297894,2020-05-07,268,92,14065,1010,10,Alle,360,1102,8.3
370,8145,2020-05-08,6,0,400,16,1,Burgenland,6,16,0.0
371,11980,2020-05-08,1,2,731,79,2,Kärnten,3,81,2.5
372,38048,2020-05-08,45,28,2793,142,3,Niederösterreich,73,170,16.5
373,45271,2020-05-08,24,4,3110,92,4,Oberösterreich,28,96,4.2
374,26080,2020-05-08,43,7,1201,117,5,Salzburg,50,124,5.6
375,34368,2020-05-08,32,6,1975,126,6,Steiermark,38,132,4.5
376,57044,2020-05-08,15,14,236,86,7,Tirol,29,100,14.0
377,14274,2020-05-08,1,2,264,25,8,Vorarlberg,3,27,7.4
378,68859,2020-05-08,91,18,3160,316,9,Wien,109,334,5.4
379,304069,2020-05-08,258,81,13870,999,10,Alle,339,1080,7.5
380,8255,2020-05-09,6,0,449,21,1,Burgenland,6,21,0.0
381,12208,2020-05-09,1,2,731,78,2,Kärnten,3,80,2.5
382,39532,2020-05-09,47,25,2787,145,3,Niederösterreich,72,170,14.7
383,46097,2020-05-09,15,5,3609,99,4,Oberösterreich,20,104,4.8
384,26560,2020-05-09,22,3,1222,121,5,Salzburg,25,124,2.4
385,35200,2020-05-09,26,6,2051,123,6,Steiermark,32,129,4.7
386,58452,2020-05-09,21,18,221,74,7,Tirol,39,92,19.6
387,15160,2020-05-09,1,1,98,25,8,Vorarlberg,2,26,3.8
388,70226,2020-05-09,91,19,3385,341,9,Wien,110,360,5.3
389,311690,2020-05-09,230,79,14553,1027,10,Alle,309,1106,7.1
390,8444,2020-05-10,6,0,465,19,1,Burgenland,6,19,0.0
391,12414,2020-05-10,2,0,727,84,2,Kärnten,2,84,0.0
392,40655,2020-05-10,44,24,2946,146,3,Niederösterreich,68,170,14.1
393,46687,2020-05-10,13,6,3900,86,4,Oberösterreich,19,92,6.5
394,26985,2020-05-10,26,2,1218,122,5,Salzburg,28,124,1.6
395,35795,2020-05-10,21,5,2321,122,6,Steiermark,26,127,3.9
396,58904,2020-05-10,18,15,226,89,7,Tirol,33,104,14.4
397,15886,2020-05-10,1,1,98,25,8,Vorarlberg,2,26,3.8
398,70738,2020-05-10,88,19,3459,342,9,Wien,107,361,5.3
399,316508,2020-05-10,219,72,15360,1035,10,Alle,291,1107,6.5
400,8477,2020-05-11,3,0,430,19,1,Burgenland,3,19,0.0
401,12496,2020-05-11,1,0,730,91,2,Kärnten,1,91,0.0
402,41724,2020-05-11,46,23,3488,147,3,Niederösterreich,69,170,13.5
403,47268,2020-05-11,15,4,3607,93,4,Oberösterreich,19,97,4.1
404,27325,2020-05-11,27,3,1217,121,5,Salzburg,30,124,2.4
405,36089,2020-05-11,20,4,2343,123,6,Steiermark,24,127,3.1
406,59430,2020-05-11,16,13,229,93,7,Tirol,29,106,12.3
407,15886,2020-05-11,1,1,98,25,8,Vorarlberg,2,26,3.8
408,70789,2020-05-11,82,20,3413,340,9,Wien,102,360,5.6
409,319484,2020-05-11,211,68,15555,1052,10,Alle,279,1120,6.1
410,8817,2020-05-12,0,0,432,16,1,Burgenland,0,16,0.0
411,12836,2020-05-12,1,0,725,87,2,Kärnten,1,87,0.0
412,42771,2020-05-12,46,21,3460,149,3,Niederösterreich,67,170,12.4
413,47935,2020-05-12,17,3,3146,92,4,Oberösterreich,20,95,3.2
414,27658,2020-05-12,27,2,1217,122,5,Salzburg,29,124,1.6
415,36535,2020-05-12,18,4,2081,116,6,Steiermark,22,120,3.3
416,61255,2020-05-12,14,12,236,98,7,Tirol,26,110,10.9
417,16146,2020-05-12,1,1,98,25,8,Vorarlberg,2,26,3.8
418,75361,2020-05-12,81,16,3169,312,9,Wien,97,328,4.9
419,329314,2020-05-12,205,59,14564,1017,10,Alle,264,1076,5.5
420,9162,2020-05-13,4,0,411,16,1,Burgenland,4,16,0.0
421,13172,2020-05-13,2,0,721,85,2,Kärnten,2,85,0.0
422,43776,2020-05-13,44,21,2854,149,3,Niederösterreich,65,170,12.4
423,48661,2020-05-13,18,2,3042,87,4,Oberösterreich,20,89,2.2
424,28272,2020-05-13,13,2,1231,122,5,Salzburg,15,124,1.6
425,37421,2020-05-13,14,5,1867,110,6,Steiermark,19,115,4.3
426,62847,2020-05-13,13,9,199,83,7,Tirol,22,92,9.8
427,16463,2020-05-13,0,0,100,26,8,Vorarlberg,0,26,0.0
428,76478,2020-05-13,80,16,3073,301,9,Wien,96,317,5.0
429,336252,2020-05-13,188,55,13498,979,10,Alle,243,1034,5.3
430,9482,2020-05-14,3,0,422,13,1,Burgenland,3,13,0.0
431,13509,2020-05-14,2,0,723,83,2,Kärnten,2,83,0.0
432,44954,2020-05-14,42,20,2661,150,3,Niederösterreich,62,170,11.8
433,49589,2020-05-14,13,1,3087,83,4,Oberösterreich,14,84,1.2
434,28942,2020-05-14,13,2,1231,122,5,Salzburg,15,124,1.6
435,38488,2020-05-14,17,4,1780,119,6,Steiermark,21,123,3.3
436,64061,2020-05-14,12,9,193,81,7,Tirol,21,90,10.0
437,16748,2020-05-14,0,0,100,21,8,Vorarlberg,0,21,0.0
438,78833,2020-05-14,78,18,2871,304,9,Wien,96,322,5.6
439,344606,2020-05-14,180,54,13068,976,10,Alle,234,1030,5.2
440,9635,2020-05-15,4,0,418,15,1,Burgenland,4,15,0.0
441,13750,2020-05-15,2,0,725,80,2,Kärnten,2,80,0.0
442,46257,2020-05-15,40,18,2557,152,3,Niederösterreich,58,170,10.6
443,50523,2020-05-15,13,1,2967,80,4,Oberösterreich,14,81,1.2
444,29600,2020-05-15,10,2,1234,122,5,Salzburg,12,124,1.6
445,39387,2020-05-15,13,4,1752,113,6,Steiermark,17,117,3.4
446,64844,2020-05-15,13,8,192,87,7,Tirol,21,95,8.4
447,17136,2020-05-15,0,0,100,25,8,Vorarlberg,0,25,0.0
448,80219,2020-05-15,70,14,2973,292,9,Wien,84,306,4.6
449,351351,2020-05-15,165,47,12918,966,10,Alle,212,1013,4.6
450,9599,2020-05-16,3,0,442,16,1,Burgenland,3,16,0.0
451,13890,2020-05-16,1,0,729,78,2,Kärnten,1,78,0.0
452,47426,2020-05-16,36,17,2494,153,3,Niederösterreich,53,170,10.0
453,51139,2020-05-16,16,1,3378,90,4,Oberösterreich,17,91,1.1
454,29989,2020-05-16,9,2,268,7,5,Salzburg,11,9,22.2
455,40431,2020-05-16,12,4,1820,88,6,Steiermark,16,92,4.3
456,65619,2020-05-16,11,9,187,75,7,Tirol,20,84,10.7
457,17398,2020-05-16,0,0,100,24,8,Vorarlberg,0,24,0.0
458,81902,2020-05-16,70,17,3161,319,9,Wien,87,336,5.1
459,357393,2020-05-16,158,50,12579,850,10,Alle,208,900,5.6
460,10046,2020-05-17,4,0,447,16,1,Burgenland,4,16,0.0
461,13941,2020-05-17,1,0,730,74,2,Kärnten,1,74,0.0
462,48584,2020-05-17,34,15,2638,155,3,Niederösterreich,49,170,8.8
463,51753,2020-05-17,12,4,3652,90,4,Oberösterreich,16,94,4.3
464,30428,2020-05-17,7,1,270,8,5,Salzburg,8,9,11.1
465,41015,2020-05-17,10,4,2142,110,6,Steiermark,14,114,3.5
466,65989,2020-05-17,10,7,190,77,7,Tirol,17,84,8.3
467,17809,2020-05-17,0,0,100,24,8,Vorarlberg,0,24,0.0
468,82944,2020-05-17,71,17,3313,336,9,Wien,88,353,4.8
469,362509,2020-05-17,149,48,13482,890,10,Alle,197,938,5.1
470,10384,2020-05-18,3,0,396,17,1,Burgenland,3,17,0.0
471,14011,2020-05-18,1,0,730,79,2,Kärnten,1,79,0.0
472,49590,2020-05-18,34,15,3228,155,3,Niederösterreich,49,170,8.8
473,52287,2020-05-18,10,2,3342,91,4,Oberösterreich,12,93,2.2
474,30480,2020-05-18,9,1,268,8,5,Salzburg,10,9,11.1
475,41389,2020-05-18,10,4,2161,123,6,Steiermark,14,127,3.1
476,66285,2020-05-18,12,6,186,94,7,Tirol,18,100,6.0
477,17898,2020-05-18,0,0,100,24,8,Vorarlberg,0,24,0.0
478,83745,2020-05-18,72,17,3252,322,9,Wien,89,339,5.0
479,366069,2020-05-18,151,45,13663,913,10,Alle,196,958,4.7
480,10431,2020-05-19,2,0,379,17,1,Burgenland,2,17,0.0
481,14410,2020-05-19,1,0,717,74,2,Kärnten,1,74,0.0
482,50494,2020-05-19,31,14,3223,156,3,Niederösterreich,45,170,8.2
483,52924,2020-05-19,11,1,2821,78,4,Oberösterreich,12,79,1.3
484,30881,2020-05-19,7,1,270,8,5,Salzburg,8,9,11.1
485,42090,2020-05-19,10,4,1778,126,6,Steiermark,14,130,3.1
486,66854,2020-05-19,13,5,181,87,7,Tirol,18,92,5.4
487,18104,2020-05-19,1,0,99,28,8,Vorarlberg,1,28,0.0
488,86247,2020-05-19,67,14,3064,306,9,Wien,81,320,4.4
489,372435,2020-05-19,143,39,12532,880,10,Alle,182,919,4.2
490,10882,2020-05-20,1,0,383,16,1,Burgenland,1,16,0.0
491,14763,2020-05-20,1,0,687,81,2,Kärnten,1,81,0.0
492,51582,2020-05-20,27,14,2590,156,3,Niederösterreich,41,170,8.2
493,54237,2020-05-20,15,0,2644,88,4,Oberösterreich,15,88,0.0
494,31196,2020-05-20,6,1,271,8,5,Salzburg,7,9,11.1
495,42955,2020-05-20,10,2,1675,124,6,Steiermark,12,126,1.6
496,67391,2020-05-20,9,6,179,87,7,Tirol,15,93,6.5
497,18390,2020-05-20,1,0,99,30,8,Vorarlberg,1,30,0.0
498,88196,2020-05-20,67,14,2953,291,9,Wien,81,305,4.6
499,379592,2020-05-20,137,37,11481,881,10,Alle,174,918,4.0
500,10958,2020-05-21,3,0,445,17,1,Burgenland,3,17,0.0
501,14910,2020-05-21,1,0,687,78,2,Kärnten,1,78,0.0
502,52614,2020-05-21,29,13,2435,157,3,Niederösterreich,42,170,7.6
503,55012,2020-05-21,14,0,3074,85,4,Oberösterreich,14,85,0.0
504,31329,2020-05-21,5,0,272,9,5,Salzburg,5,9,0.0
505,44061,2020-05-21,7,2,1677,111,6,Steiermark,9,113,1.8
506,67834,2020-05-21,10,4,150,82,7,Tirol,14,86,4.7
507,18691,2020-05-21,1,0,99,26,8,Vorarlberg,1,26,0.0
508,90228,2020-05-21,86,13,3119,304,9,Wien,99,317,4.1
509,385637,2020-05-21,156,32,11958,869,10,Alle,188,901,3.6
510,10959,2020-05-22,1,0,445,16,1,Burgenland,1,16,0.0
511,15022,2020-05-22,1,0,687,79,2,Kärnten,1,79,0.0
512,53663,2020-05-22,26,12,2435,158,3,Niederösterreich,38,170,7.1
513,55839,2020-05-22,12,0,3176,90,4,Oberösterreich,12,90,0.0
514,31536,2020-05-22,4,0,273,9,5,Salzburg,4,9,0.0
515,44859,2020-05-22,8,2,1960,114,6,Steiermark,10,116,1.7
516,68390,2020-05-22,9,3,160,74,7,Tirol,12,77,3.9
517,18917,2020-05-22,1,0,99,26,8,Vorarlberg,1,26,0.0
518,91303,2020-05-22,66,14,3071,311,9,Wien,80,325,4.3
519,390488,2020-05-22,128,31,12306,877,10,Alle,159,908,3.4
520,11134,2020-05-23,1,0,453,17,1,Burgenland,1,17,0.0
521,15144,2020-05-23,0,0,688,82,2,Kärnten,0,82,0.0
522,56075,2020-05-23,24,11,2945,159,3,Niederösterreich,35,170,6.5
523,56186,2020-05-23,11,0,3408,94,4,Oberösterreich,11,94,0.0
524,31748,2020-05-23,4,0,273,9,5,Salzburg,4,9,0.0
525,45449,2020-05-23,8,2,1834,119,6,Steiermark,10,121,1.7
526,68790,2020-05-23,9,3,160,74,7,Tirol,12,77,3.9
527,18917,2020-05-23,0,0,100,26,8,Vorarlberg,0,26,0.0
528,92920,2020-05-23,59,12,3263,319,9,Wien,71,331,3.6
529,396363,2020-05-23,116,28,13124,899,10,Alle,144,927,3.0
530,11300,2020-05-24,2,0,465,16,1,Burgenland,2,16,0.0
531,15198,2020-05-24,0,0,688,88,2,Kärnten,0,88,0.0
532,57841,2020-05-24,20,11,2746,159,3,Niederösterreich,31,170,6.5
533,56693,2020-05-24,9,0,3575,104,4,Oberösterreich,9,104,0.0
534,31854,2020-05-24,4,0,273,9,5,Salzburg,4,9,0.0
535,45985,2020-05-24,6,1,2118,110,6,Steiermark,7,111,0.9
536,69231,2020-05-24,9,4,149,80,7,Tirol,13,84,4.8
537,19543,2020-05-24,0,0,100,26,8,Vorarlberg,0,26,0.0
538,94212,2020-05-24,58,13,3253,313,9,Wien,71,326,4.0
539,401857,2020-05-24,108,29,13367,905,10,Alle,137,934,3.1
540,11416,2020-05-25,2,0,418,16,1,Burgenland,2,16,0.0
541,15255,2020-05-25,0,0,688,86,2,Kärnten,0,86,0.0
542,58868,2020-05-25,21,11,3215,159,3,Niederösterreich,32,170,6.5
543,57222,2020-05-25,8,1,3334,109,4,Oberösterreich,9,110,0.9
544,31932,2020-05-25,2,0,275,9,5,Salzburg,2,9,0.0
545,46349,2020-05-25,6,1,2144,120,6,Steiermark,7,121,0.8
546,69519,2020-05-25,9,4,151,82,7,Tirol,13,86,4.7
547,19543,2020-05-25,0,0,100,26,8,Vorarlberg,0,26,0.0
548,95237,2020-05-25,60,14,3161,313,9,Wien,74,327,4.3
549,405341,2020-05-25,108,31,13486,920,10,Alle,139,951,3.3
550,11571,2020-05-26,2,0,375,18,1,Burgenland,2,18,0.0
551,15717,2020-05-26,0,0,688,86,2,Kärnten,0,86,0.0
552,60525,2020-05-26,19,13,3165,157,3,Niederösterreich,32,170,7.6
553,57949,2020-05-26,6,1,2679,89,4,Oberösterreich,7,90,1.1
554,32097,2020-05-26,2,0,275,9,5,Salzburg,2,9,0.0
555,46945,2020-05-26,5,1,1776,119,6,Steiermark,6,120,0.8
556,70096,2020-05-26,8,4,133,89,7,Tirol,12,93,4.3
557,19854,2020-05-26,0,0,100,24,8,Vorarlberg,0,24,0.0
558,96431,2020-05-26,53,13,2949,292,9,Wien,66,305,4.3
559,411185,2020-05-26,95,32,12140,883,10,Alle,127,915,3.5
560,12236,2020-05-27,2,0,354,11,1,Burgenland,2,11,0.0
561,15924,2020-05-27,0,0,688,83,2,Kärnten,0,83,0.0
562,62155,2020-05-27,15,13,2530,157,3,Niederösterreich,28,170,7.6
563,59169,2020-05-27,7,0,2585,90,4,Oberösterreich,7,90,0.0
564,32333,2020-05-27,2,0,186,2,5,Salzburg,2,2,0.0
565,47783,2020-05-27,6,1,1587,113,6,Steiermark,7,114,0.9
566,70667,2020-05-27,7,4,128,90,7,Tirol,11,94,4.3
567,20095,2020-05-27,0,0,100,26,8,Vorarlberg,0,26,0.0
568,98344,2020-05-27,45,14,2743,303,9,Wien,59,317,4.4
569,418706,2020-05-27,84,32,10901,875,10,Alle,116,907,3.5
570,12623,2020-05-28,2,0,365,12,1,Burgenland,2,12,0.0
571,16295,2020-05-28,0,0,688,84,2,Kärnten,0,84,0.0
572,64267,2020-05-28,13,13,2313,157,3,Niederösterreich,26,170,7.6
573,60447,2020-05-28,7,0,2460,84,4,Oberösterreich,7,84,0.0
574,32726,2020-05-28,2,0,186,2,5,Salzburg,2,2,0.0
575,48843,2020-05-28,7,1,1645,112,6,Steiermark,8,113,0.9
576,71706,2020-05-28,6,4,126,81,7,Tirol,10,85,4.7
577,20477,2020-05-28,0,0,100,26,8,Vorarlberg,0,26,0.0
578,99988,2020-05-28,40,12,2664,295,9,Wien,52,307,3.9
579,427372,2020-05-28,77,30,10547,853,10,Alle,107,883,3.4
580,12875,2020-05-29,2,0,357,17,1,Burgenland,2,17,0.0
581,16663,2020-05-29,0,0,688,87,2,Kärnten,0,87,0.0
582,66422,2020-05-29,15,11,2260,159,3,Niederösterreich,26,170,6.5
583,61552,2020-05-29,7,0,2574,84,4,Oberösterreich,7,84,0.0
584,32933,2020-05-29,3,0,169,2,5,Salzburg,3,2,0.0
585,49559,2020-05-29,6,1,1536,107,6,Steiermark,7,108,0.9
586,72349,2020-05-29,9,3,115,78,7,Tirol,12,81,3.7
587,20871,2020-05-29,0,0,100,28,8,Vorarlberg,0,28,0.0
588,101078,2020-05-29,36,10,2687,282,9,Wien,46,292,3.4
589,434302,2020-05-29,78,25,10486,844,10,Alle,103,869,2.9
590,13058,2020-05-30,2,0,440,13,1,Burgenland,2,13,0.0
591,16935,2020-05-30,0,0,80,40,2,Kärnten,0,40,0.0
592,68149,2020-05-30,15,10,2265,160,3,Niederösterreich,25,170,5.9
593,62343,2020-05-30,7,0,2574,84,4,Oberösterreich,7,84,0.0
594,33149,2020-05-30,0,0,172,2,5,Salzburg,0,2,0.0
595,50347,2020-05-30,6,0,1602,113,6,Steiermark,6,113,0.0
596,72770,2020-05-30,9,3,116,88,7,Tirol,12,91,3.3
597,21298,2020-05-30,0,0,100,26,8,Vorarlberg,0,26,0.0
598,104094,2020-05-30,36,10,2949,297,9,Wien,46,307,3.3
599,442143,2020-05-30,75,23,10298,823,10,Alle,98,846,2.7
600,12953,2020-05-31,2,0,482,17,1,Burgenland,2,17,0.0
601,17104,2020-05-31,0,0,80,40,2,Kärnten,0,40,0.0
602,69621,2020-05-31,12,10,2516,160,3,Niederösterreich,22,170,5.9
603,62819,2020-05-31,7,0,2574,84,4,Oberösterreich,7,84,0.0
604,33275,2020-05-31,0,0,172,2,5,Salzburg,0,2,0.0
605,50817,2020-05-31,6,0,1602,113,6,Steiermark,6,113,0.0
606,73319,2020-05-31,4,3,125,75,7,Tirol,7,78,3.8
607,21763,2020-05-31,0,0,100,26,8,Vorarlberg,0,26,0.0
608,106863,2020-05-31,39,14,3177,317,9,Wien,53,331,4.2
609,448534,2020-05-31,70,27,10828,834,10,Alle,97,861,3.1
610,13028,2020-06-01,2,0,463,20,1,Burgenland,2,20,0.0
611,17204,2020-06-01,0,0,80,40,2,Kärnten,0,40,0.0
612,71433,2020-06-01,11,10,3230,160,3,Niederösterreich,21,170,5.9
613,63303,2020-06-01,7,0,2574,84,4,Oberösterreich,7,84,0.0
614,33355,2020-06-01,0,0,172,2,5,Salzburg,0,2,0.0
615,51330,2020-06-01,5,2,2080,119,6,Steiermark,7,121,1.7
616,73515,2020-06-01,4,3,124,79,7,Tirol,7,82,3.7
617,21789,2020-06-01,0,0,100,26,8,Vorarlberg,0,26,0.0
618,106863,2020-06-01,39,14,3177,317,9,Wien,53,331,4.2
619,451820,2020-06-01,68,29,12000,847,10,Alle,97,876,3.3
620,13089,2020-06-02,2,0,403,17,1,Burgenland,2,17,0.0
621,17395,2020-06-02,0,0,80,40,2,Kärnten,0,40,0.0
622,72439,2020-06-02,11,9,3390,161,3,Niederösterreich,20,170,5.3
623,63575,2020-06-02,3,0,3184,84,4,Oberösterreich,3,84,0.0
624,33485,2020-06-02,0,0,172,2,5,Salzburg,0,2,0.0
625,51705,2020-06-02,5,2,2061,118,6,Steiermark,7,120,1.7
626,73959,2020-06-02,4,3,130,77,7,Tirol,7,80,3.8
627,21789,2020-06-02,0,0,100,25,8,Vorarlberg,0,25,0.0
628,108942,2020-06-02,37,12,3334,309,9,Wien,49,321,3.7
629,456378,2020-06-02,62,26,12854,833,10,Alle,88,859,3.0
630,13232,2020-06-03,2,0,371,17,1,Burgenland,2,17,0.0
631,17836,2020-06-03,0,0,80,40,2,Kärnten,0,40,0.0
632,73642,2020-06-03,13,6,3159,164,3,Niederösterreich,19,170,3.5
633,64275,2020-06-03,3,0,2490,85,4,Oberösterreich,3,85,0.0
634,33675,2020-06-03,0,0,134,2,5,Salzburg,0,2,0.0
635,52371,2020-06-03,5,2,1638,120,6,Steiermark,7,122,1.6
636,74409,2020-06-03,5,2,110,75,7,Tirol,7,77,2.6
637,21931,2020-06-03,0,0,100,23,8,Vorarlberg,0,23,0.0
638,111587,2020-06-03,38,11,2810,313,9,Wien,49,324,3.4
639,462958,2020-06-03,66,21,10892,839,10,Alle,87,860,2.4
640,13995,2020-06-04,2,0,354,13,1,Burgenland,2,13,0.0
641,18212,2020-06-04,0,0,80,40,2,Kärnten,0,40,0.0
642,74761,2020-06-04,12,6,2369,164,3,Niederösterreich,18,170,3.5
643,65176,2020-06-04,4,0,2217,87,4,Oberösterreich,4,87,0.0
644,33840,2020-06-04,0,0,134,2,5,Salzburg,0,2,0.0
645,53370,2020-06-04,4,1,1528,102,6,Steiermark,5,103,1.0
646,75312,2020-06-04,3,2,107,58,7,Tirol,5,60,3.3
647,22248,2020-06-04,0,0,100,19,8,Vorarlberg,0,19,0.0
648,114552,2020-06-04,40,13,2526,284,9,Wien,53,297,4.4
649,471466,2020-06-04,65,22,9415,769,10,Alle,87,791,2.8
650,14101,2020-06-05,2,0,345,15,1,Burgenland,2,15,0.0
651,18555,2020-06-05,0,0,80,40,2,Kärnten,0,40,0.0
652,76964,2020-06-05,12,6,2011,164,3,Niederösterreich,18,170,3.5
653,66117,2020-06-05,2,0,2156,89,4,Oberösterreich,2,89,0.0
654,34111,2020-06-05,0,0,134,2,5,Salzburg,0,2,0.0
655,54110,2020-06-05,2,1,1357,107,6,Steiermark,3,108,0.9
656,76246,2020-06-05,3,2,105,56,7,Tirol,5,58,3.4
657,22739,2020-06-05,0,0,100,25,8,Vorarlberg,0,25,0.0
658,116506,2020-06-05,34,11,2386,282,9,Wien,45,293,3.8
659,479449,2020-06-05,55,20,8674,780,10,Alle,75,800,2.5
660,14167,2020-06-06,2,0,362,12,1,Burgenland,2,12,0.0
661,19066,2020-06-06,0,0,80,40,2,Kärnten,0,40,0.0
662,77996,2020-06-06,11,5,1949,165,3,Niederösterreich,16,170,2.9
663,66859,2020-06-06,2,0,2156,89,4,Oberösterreich,2,89,0.0
664,34297,2020-06-06,0,0,134,2,5,Salzburg,0,2,0.0
665,54995,2020-06-06,2,1,1450,101,6,Steiermark,3,102,1.0
666,76524,2020-06-06,1,1,104,59,7,Tirol,2,60,1.7
667,23126,2020-06-06,0,0,100,25,8,Vorarlberg,0,25,0.0
668,118882,2020-06-06,37,10,2613,303,9,Wien,47,313,3.2
669,485912,2020-06-06,55,17,8948,796,10,Alle,72,813,2.1
670,14291,2020-06-07,2,0,435,13,1,Burgenland,2,13,0.0
671,19241,2020-06-07,0,0,80,40,2,Kärnten,0,40,0.0
672,79508,2020-06-07,9,5,2067,165,3,Niederösterreich,14,170,2.9
673,67337,2020-06-07,2,0,2156,89,4,Oberösterreich,2,89,0.0
674,34379,2020-06-07,0,0,134,2,5,Salzburg,0,2,0.0
675,55347,2020-06-07,1,1,1800,103,6,Steiermark,2,104,1.0
676,76978,2020-06-07,1,1,104,59,7,Tirol,2,60,1.7
677,23634,2020-06-07,0,0,100,25,8,Vorarlberg,0,25,0.0
678,118882,2020-06-07,37,10,2613,303,9,Wien,47,313,3.2
679,489597,2020-06-07,52,17,9489,799,10,Alle,69,816,2.1
680,14353,2020-06-08,2,0,387,12,1,Burgenland,2,12,0.0
681,19455,2020-06-08,0,0,80,40,2,Kärnten,0,40,0.0
682,80732,2020-06-08,8,6,2803,164,3,Niederösterreich,14,170,3.5
683,67670,2020-06-08,5,0,2939,96,4,Oberösterreich,5,96,0.0
684,34398,2020-06-08,0,0,134,2,5,Salzburg,0,2,0.0
685,55475,2020-06-08,1,1,1864,102,6,Steiermark,2,103,1.0
686,77142,2020-06-08,1,1,104,59,7,Tirol,2,60,1.7
687,23712,2020-06-08,0,0,100,25,8,Vorarlberg,0,25,0.0
688,121824,2020-06-08,48,9,2603,307,9,Wien,57,316,2.8
689,494761,2020-06-08,65,17,11014,807,10,Alle,82,824,2.1
690,14403,2020-06-09,0,0,314,15,1,Burgenland,0,15,0.0
691,19818,2020-06-09,0,0,80,40,2,Kärnten,0,40,0.0
692,82507,2020-06-09,10,5,2749,165,3,Niederösterreich,15,170,2.9
693,68184,2020-06-09,5,1,2367,92,4,Oberösterreich,6,93,1.1
694,34657,2020-06-09,0,0,134,2,5,Salzburg,0,2,0.0
695,56170,2020-06-09,1,1,1586,94,6,Steiermark,2,95,1.1
696,77437,2020-06-09,1,2,109,78,7,Tirol,3,80,2.5
697,24081,2020-06-09,0,0,100,25,8,Vorarlberg,0,25,0.0
698,123664,2020-06-09,48,10,2499,312,9,Wien,58,322,3.1
699,500921,2020-06-09,65,19,9938,823,10,Alle,84,842,2.3
700,14538,2020-06-10,0,0,323,17,1,Burgenland,0,17,0.0
701,20221,2020-06-10,0,0,80,40,2,Kärnten,0,40,0.0
702,84197,2020-06-10,8,4,1936,166,3,Niederösterreich,12,170,2.4
703,68713,2020-06-10,4,1,2110,85,4,Oberösterreich,5,86,1.2
704,34160,2020-06-10,0,1,74,1,5,Salzburg,1,2,50.0
705,56717,2020-06-10,1,1,1392,94,6,Steiermark,2,95,1.1
706,77920,2020-06-10,1,1,108,64,7,Tirol,2,65,1.5
707,24189,2020-06-10,0,0,100,29,8,Vorarlberg,0,29,0.0
708,125689,2020-06-10,49,9,2194,252,9,Wien,58,261,3.4
709,506344,2020-06-10,63,17,8317,748,10,Alle,80,765,2.2
710,14564,2020-06-11,0,0,385,18,1,Burgenland,0,18,0.0
711,20509,2020-06-11,0,0,80,40,2,Kärnten,0,40,0.0
712,85688,2020-06-11,11,2,1741,168,3,Niederösterreich,13,170,1.2
713,69374,2020-06-11,4,1,2110,85,4,Oberösterreich,5,86,1.2
714,34481,2020-06-11,1,0,73,2,5,Salzburg,1,2,0.0
715,57184,2020-06-11,1,1,1406,82,6,Steiermark,2,83,1.2
716,78316,2020-06-11,1,1,111,59,7,Tirol,2,60,1.7
717,24506,2020-06-11,0,0,100,25,8,Vorarlberg,0,25,0.0
718,125689,2020-06-11,49,9,2194,252,9,Wien,58,261,3.4
719,510311,2020-06-11,67,14,8200,731,10,Alle,81,745,1.9
720,14574,2020-06-12,0,0,368,17,1,Burgenland,0,17,0.0
721,20774,2020-06-12,0,0,80,40,2,Kärnten,0,40,0.0
722,86793,2020-06-12,12,0,1858,170,3,Niederösterreich,12,170,0.0
723,69690,2020-06-12,4,1,2508,92,4,Oberösterreich,5,93,1.1
724,34560,2020-06-12,1,0,73,2,5,Salzburg,1,2,0.0
725,57505,2020-06-12,2,1,1406,82,6,Steiermark,3,83,1.2
726,78563,2020-06-12,1,1,111,59,7,Tirol,2,60,1.7
727,24983,2020-06-12,0,0,100,25,8,Vorarlberg,0,25,0.0
728,129139,2020-06-12,40,6,2412,261,9,Wien,46,267,2.2
729,516581,2020-06-12,60,9,8916,748,10,Alle,69,757,1.2
730,14640,2020-06-13,0,0,417,15,1,Burgenland,0,15,0.0
731,21035,2020-06-13,0,0,80,40,2,Kärnten,0,40,0.0
732,88187,2020-06-13,12,2,2528,168,3,Niederösterreich,14,170,1.2
733,70099,2020-06-13,4,1,2508,92,4,Oberösterreich,5,93,1.1
734,34743,2020-06-13,1,0,73,2,5,Salzburg,1,2,0.0
735,57817,2020-06-13,0,0,1608,81,6,Steiermark,0,81,0.0
736,78881,2020-06-13,1,1,105,84,7,Tirol,2,85,1.2
737,25263,2020-06-13,0,0,100,25,8,Vorarlberg,0,25,0.0
738,130311,2020-06-13,44,6,2623,350,9,Wien,50,356,1.7
739,520976,2020-06-13,62,10,10042,857,10,Alle,72,867,1.2
740,14896,2020-06-14,0,0,417,14,1,Burgenland,0,14,0.0
741,21279,2020-06-14,0,0,80,40,2,Kärnten,0,40,0.0
742,89200,2020-06-14,8,2,2253,168,3,Niederösterreich,10,170,1.2
743,70287,2020-06-14,4,1,2508,92,4,Oberösterreich,5,93,1.1
744,34818,2020-06-14,1,0,73,2,5,Salzburg,1,2,0.0
745,57989,2020-06-14,0,1,1861,80,6,Steiermark,1,81,1.2
746,79515,2020-06-14,1,1,105,84,7,Tirol,2,85,1.2
747,25504,2020-06-14,0,0,100,25,8,Vorarlberg,0,25,0.0
748,131352,2020-06-14,43,7,2839,334,9,Wien,50,341,2.1
749,524840,2020-06-14,57,12,10236,839,10,Alle,69,851,1.4
750,14968,2020-06-15,0,0,393,13,1,Burgenland,0,13,0.0
751,21395,2020-06-15,0,0,80,40,2,Kärnten,0,40,0.0
752,90321,2020-06-15,9,2,2820,168,3,Niederösterreich,11,170,1.2
753,70615,2020-06-15,8,2,2710,95,4,Oberösterreich,10,97,2.1
754,34884,2020-06-15,1,0,73,2,5,Salzburg,1,2,0.0
755,58116,2020-06-15,0,2,1939,85,6,Steiermark,2,87,2.3
756,79665,2020-06-15,1,1,105,84,7,Tirol,2,85,1.2
757,25504,2020-06-15,0,0,100,25,8,Vorarlberg,0,25,0.0
758,132202,2020-06-15,45,8,2777,321,9,Wien,53,329,2.4
759,527670,2020-06-15,64,15,10997,833,10,Alle,79,848,1.8
760,15331,2020-06-16,0,0,344,14,1,Burgenland,0,14,0.0
761,21973,2020-06-16,0,0,80,40,2,Kärnten,0,40,0.0
762,91352,2020-06-16,8,1,2759,169,3,Niederösterreich,9,170,0.6
763,71051,2020-06-16,8,1,2310,86,4,Oberösterreich,9,87,1.1
764,34971,2020-06-16,1,0,73,2,5,Salzburg,1,2,0.0
765,58507,2020-06-16,1,2,1651,93,6,Steiermark,3,95,2.1
766,79914,2020-06-16,1,2,103,78,7,Tirol,3,80,2.5
767,25704,2020-06-16,0,0,100,25,8,Vorarlberg,0,25,0.0
768,133897,2020-06-16,47,6,2414,326,9,Wien,53,332,1.8
769,532700,2020-06-16,66,12,9834,833,10,Alle,78,845,1.4
770,15512,2020-06-17,0,0,321,14,1,Burgenland,0,14,0.0
771,22357,2020-06-17,0,0,80,40,2,Kärnten,0,40,0.0
772,92627,2020-06-17,6,1,1951,169,3,Niederösterreich,7,170,0.6
773,71671,2020-06-17,7,1,2126,77,4,Oberösterreich,8,78,1.3
774,35253,2020-06-17,1,0,73,2,5,Salzburg,1,2,0.0
775,59126,2020-06-17,1,3,1443,83,6,Steiermark,4,86,3.5
776,80367,2020-06-17,1,1,101,71,7,Tirol,2,72,1.4
777,25903,2020-06-17,0,0,100,25,8,Vorarlberg,0,25,0.0
778,137799,2020-06-17,44,5,2266,325,9,Wien,49,330,1.5
779,540615,2020-06-17,60,11,8461,806,10,Alle,71,817,1.3
780,15565,2020-06-18,0,0,342,13,1,Burgenland,0,13,0.0
781,22722,2020-06-18,0,0,80,40,2,Kärnten,0,40,0.0
782,93840,2020-06-18,8,1,1741,169,3,Niederösterreich,9,170,0.6
783,72333,2020-06-18,7,0,2038,73,4,Oberösterreich,7,73,0.0
784,35408,2020-06-18,0,0,73,2,5,Salzburg,0,2,0.0
785,59714,2020-06-18,3,1,1212,84,6,Steiermark,4,85,1.2
786,80682,2020-06-18,1,1,105,51,7,Tirol,2,52,1.9
787,26173,2020-06-18,0,0,100,23,8,Vorarlberg,0,23,0.0
788,139490,2020-06-18,45,5,2185,296,9,Wien,50,301,1.7
789,545927,2020-06-18,64,8,7876,751,10,Alle,72,759,1.1
790,15668,2020-06-19,0,0,326,13,1,Burgenland,0,13,0.0
791,23094,2020-06-19,0,0,80,40,2,Kärnten,0,40,0.0
792,94919,2020-06-19,10,1,1571,169,3,Niederösterreich,11,170,0.6
793,72865,2020-06-19,7,0,2059,78,4,Oberösterreich,7,78,0.0
794,35638,2020-06-19,0,0,73,2,5,Salzburg,0,2,0.0
795,60149,2020-06-19,4,1,1282,99,6,Steiermark,5,100,1.0
796,81105,2020-06-19,1,0,107,51,7,Tirol,1,51,0.0
797,26173,2020-06-19,0,0,100,24,8,Vorarlberg,0,24,0.0
798,142519,2020-06-19,46,5,2009,274,9,Wien,51,279,1.8
799,552130,2020-06-19,68,7,7607,750,10,Alle,75,757,0.9
800,15742,2020-06-20,2,0,404,12,1,Burgenland,2,12,0.0
801,23379,2020-06-20,1,0,79,40,2,Kärnten,1,40,0.0
802,96193,2020-06-20,10,2,1580,168,3,Niederösterreich,12,170,1.2
803,73281,2020-06-20,7,0,2059,78,4,Oberösterreich,7,78,0.0
804,35796,2020-06-20,2,0,73,2,5,Salzburg,2,2,0.0
805,60467,2020-06-20,4,1,1277,103,6,Steiermark,5,104,1.0
806,81625,2020-06-20,1,0,105,64,7,Tirol,1,64,0.0
807,26709,2020-06-20,0,0,100,25,8,Vorarlberg,0,25,0.0
808,145016,2020-06-20,39,5,2375,300,9,Wien,44,305,1.6
809,558208,2020-06-20,66,8,8052,792,10,Alle,74,800,1.0
810,15378,2020-06-21,2,0,395,12,1,Burgenland,2,12,0.0
811,22596,2020-06-21,1,0,79,40,2,Kärnten,1,40,0.0
812,97526,2020-06-21,8,2,1774,168,3,Niederösterreich,10,170,1.2
813,73567,2020-06-21,7,0,2059,78,4,Oberösterreich,7,78,0.0
814,36000,2020-06-21,3,0,73,2,5,Salzburg,3,2,0.0
815,60808,2020-06-21,4,1,1699,96,6,Steiermark,5,97,1.0
816,81827,2020-06-21,2,0,104,64,7,Tirol,2,64,0.0
817,26899,2020-06-21,0,0,100,25,8,Vorarlberg,0,25,0.0
818,145983,2020-06-21,34,5,2650,307,9,Wien,39,312,1.6
819,560584,2020-06-21,61,8,8933,792,10,Alle,69,800,1.0
820,15970,2020-06-22,0,0,359,13,1,Burgenland,0,13,0.0
821,23941,2020-06-22,1,0,79,40,2,Kärnten,1,40,0.0
822,98881,2020-06-22,6,3,2702,167,3,Niederösterreich,9,170,1.8
823,73889,2020-06-22,7,0,2656,91,4,Oberösterreich,7,91,0.0
824,36186,2020-06-22,3,0,73,2,5,Salzburg,3,2,0.0
825,61098,2020-06-22,3,1,1757,105,6,Steiermark,4,106,0.9
826,82000,2020-06-22,2,0,104,64,7,Tirol,2,64,0.0
827,27049,2020-06-22,0,0,100,25,8,Vorarlberg,0,25,0.0
828,146786,2020-06-22,37,6,2553,303,9,Wien,43,309,1.9
829,565800,2020-06-22,59,10,10383,810,10,Alle,69,820,1.2
830,16090,2020-06-23,0,0,314,16,1,Burgenland,0,16,0.0
831,24315,2020-06-23,1,0,79,40,2,Kärnten,1,40,0.0
832,99930,2020-06-23,7,4,2700,166,3,Niederösterreich,11,170,2.4
833,74322,2020-06-23,5,0,2057,89,4,Oberösterreich,5,89,0.0
834,36560,2020-06-23,3,0,46,2,5,Salzburg,3,2,0.0
835,61539,2020-06-23,3,1,1453,107,6,Steiermark,4,108,0.9
836,82314,2020-06-23,2,0,104,76,7,Tirol,2,76,0.0
837,27200,2020-06-23,0,0,100,25,8,Vorarlberg,0,25,0.0
838,150203,2020-06-23,36,6,2435,313,9,Wien,42,319,1.9
839,572473,2020-06-23,57,11,9288,834,10,Alle,68,845,1.3
840,16156,2020-06-24,0,0,289,15,1,Burgenland,0,15,0.0
841,24731,2020-06-24,2,0,78,40,2,Kärnten,2,40,0.0
842,101104,2020-06-24,4,4,1918,166,3,Niederösterreich,8,170,2.4
843,75108,2020-06-24,7,0,1735,70,4,Oberösterreich,7,70,0.0
844,36907,2020-06-24,3,0,46,2,5,Salzburg,3,2,0.0
845,62016,2020-06-24,4,1,1286,86,6,Steiermark,5,87,1.1
846,82716,2020-06-24,2,0,112,71,7,Tirol,2,71,0.0
847,27356,2020-06-24,0,0,100,25,8,Vorarlberg,0,25,0.0
848,152490,2020-06-24,37,6,2175,295,9,Wien,43,301,2.0
849,578584,2020-06-24,59,11,7739,770,10,Alle,70,781,1.4
850,16247,2020-06-25,0,0,306,12,1,Burgenland,0,12,0.0
851,25219,2020-06-25,2,0,78,40,2,Kärnten,2,40,0.0
852,101888,2020-06-25,8,3,1688,167,3,Niederösterreich,11,170,1.8
853,75768,2020-06-25,10,1,1814,70,4,Oberösterreich,11,71,1.4
854,37203,2020-06-25,3,0,46,2,5,Salzburg,3,2,0.0
855,62734,2020-06-25,3,1,1106,79,6,Steiermark,4,80,1.2
856,83278,2020-06-25,2,0,99,56,7,Tirol,2,56,0.0
857,27569,2020-06-25,0,0,99,22,8,Vorarlberg,0,22,0.0
858,154337,2020-06-25,32,6,2055,284,9,Wien,38,290,2.1
859,584243,2020-06-25,60,11,7291,732,10,Alle,71,743,1.5
860,15802,2020-06-26,0,0,299,10,1,Burgenland,0,10,0.0
861,25613,2020-06-26,1,0,78,40,2,Kärnten,1,40,0.0
862,103444,2020-06-26,8,3,1611,167,3,Niederösterreich,11,170,1.8
863,76606,2020-06-26,10,0,1944,63,4,Oberösterreich,10,63,0.0
864,37427,2020-06-26,4,0,46,2,5,Salzburg,4,2,0.0
865,63229,2020-06-26,1,1,1148,70,6,Steiermark,2,71,1.4
866,83840,2020-06-26,3,0,100,48,7,Tirol,3,48,0.0
867,28055,2020-06-26,0,0,100,23,8,Vorarlberg,0,23,0.0
868,156426,2020-06-26,33,6,2125,275,9,Wien,39,281,2.1
869,590442,2020-06-26,60,10,7451,698,10,Alle,70,708,1.4
870,16441,2020-06-27,0,0,385,10,1,Burgenland,0,10,0.0
871,25956,2020-06-27,1,0,79,40,2,Kärnten,1,40,0.0
872,105134,2020-06-27,13,2,1655,168,3,Niederösterreich,15,170,1.2
873,77276,2020-06-27,10,0,1944,63,4,Oberösterreich,10,63,0.0
874,37607,2020-06-27,4,0,45,2,5,Salzburg,4,2,0.0
875,63610,2020-06-27,0,1,1219,78,6,Steiermark,1,79,1.3
876,84343,2020-06-27,3,1,105,49,7,Tirol,4,50,2.0
877,28316,2020-06-27,0,0,100,27,8,Vorarlberg,0,27,0.0
878,158812,2020-06-27,30,6,2311,289,9,Wien,36,295,2.0
879,597495,2020-06-27,61,10,7843,726,10,Alle,71,736,1.4
880,16490,2020-06-28,0,0,425,13,1,Burgenland,0,13,0.0
881,26164,2020-06-28,1,0,79,40,2,Kärnten,1,40,0.0
882,106548,2020-06-28,13,1,1878,169,3,Niederösterreich,14,170,0.6
883,77672,2020-06-28,10,0,1944,63,4,Oberösterreich,10,63,0.0
884,37757,2020-06-28,4,0,45,2,5,Salzburg,4,2,0.0
885,64084,2020-06-28,0,1,1701,79,6,Steiermark,1,80,1.2
886,84612,2020-06-28,3,1,105,49,7,Tirol,4,50,2.0
887,28723,2020-06-28,0,0,100,27,8,Vorarlberg,0,27,0.0
888,160470,2020-06-28,31,6,2505,286,9,Wien,37,292,2.1
889,602520,2020-06-28,62,9,8782,728,10,Alle,71,737,1.2
890,16660,2020-06-29,1,0,381,13,1,Burgenland,1,13,0.0
891,26315,2020-06-29,1,0,79,40,2,Kärnten,1,40,0.0
892,107831,2020-06-29,11,1,2690,169,3,Niederösterreich,12,170,0.6
893,78199,2020-06-29,15,0,2633,83,4,Oberösterreich,15,83,0.0
894,37854,2020-06-29,4,0,45,2,5,Salzburg,4,2,0.0
895,64306,2020-06-29,0,1,1828,81,6,Steiermark,1,82,1.2
896,84745,2020-06-29,3,1,105,49,7,Tirol,4,50,2.0
897,28819,2020-06-29,0,0,100,27,8,Vorarlberg,0,27,0.0
898,161646,2020-06-29,31,5,2554,303,9,Wien,36,308,1.6
899,606375,2020-06-29,66,8,10415,767,10,Alle,74,775,1.0
900,16710,2020-06-30,0,0,338,10,1,Burgenland,0,10,0.0
901,26714,2020-06-30,1,0,79,40,2,Kärnten,1,40,0.0
902,109467,2020-06-30,12,1,2645,169,3,Niederösterreich,13,170,0.6
903,78894,2020-06-30,13,0,2001,79,4,Oberösterreich,13,79,0.0
904,38214,2020-06-30,0,0,45,2,5,Salzburg,0,2,0.0
905,64736,2020-06-30,0,1,1444,83,6,Steiermark,1,84,1.2
906,85049,2020-06-30,2,0,98,66,7,Tirol,2,66,0.0
907,29003,2020-06-30,0,0,100,27,8,Vorarlberg,0,27,0.0
908,163969,2020-06-30,30,4,2219,246,9,Wien,34,250,1.6
909,612756,2020-06-30,58,6,8969,722,10,Alle,64,728,0.8
910,16810,2020-07-01,0,0,296,10,1,Burgenland,0,10,0.0
911,27628,2020-07-01,1,0,79,40,2,Kärnten,1,40,0.0
912,110816,2020-07-01,13,1,1926,169,3,Niederösterreich,14,170,0.6
913,79792,2020-07-01,13,0,1821,77,4,Oberösterreich,13,77,0.0
914,38576,2020-07-01,5,0,35,0,5,Salzburg,5,0,0.0
915,65280,2020-07-01,1,1,1301,74,6,Steiermark,2,75,1.3
916,85674,2020-07-01,2,0,103,63,7,Tirol,2,63,0.0
917,29248,2020-07-01,0,0,100,25,8,Vorarlberg,0,25,0.0
918,167042,2020-07-01,30,7,2225,288,9,Wien,37,295,2.4
919,620866,2020-07-01,65,9,7886,746,10,Alle,74,755,1.2
920,16858,2020-07-02,1,0,273,6,1,Burgenland,1,6,0.0
921,28024,2020-07-02,1,0,79,40,2,Kärnten,1,40,0.0
922,112305,2020-07-02,13,1,1797,169,3,Niederösterreich,14,170,0.6
923,81225,2020-07-02,16,0,1851,77,4,Oberösterreich,16,77,0.0
924,38868,2020-07-02,5,0,35,0,5,Salzburg,5,0,0.0
925,65928,2020-07-02,0,1,1057,88,6,Steiermark,1,89,1.1
926,86243,2020-07-02,2,0,1,31,7,Tirol,2,31,0.0
927,29490,2020-07-02,0,0,100,21,8,Vorarlberg,0,21,0.0
928,169759,2020-07-02,24,5,2081,284,9,Wien,29,289,1.7
929,628700,2020-07-02,62,7,7274,716,10,Alle,69,723,1.0
930,16946,2020-07-03,1,0,345,7,1,Burgenland,1,7,0.0
931,28463,2020-07-03,1,0,79,40,2,Kärnten,1,40,0.0
932,113704,2020-07-03,11,2,1661,168,3,Niederösterreich,13,170,1.2
933,82481,2020-07-03,19,0,1858,75,4,Oberösterreich,19,75,0.0
934,39115,2020-07-03,5,0,35,0,5,Salzburg,5,0,0.0
935,66577,2020-07-03,0,1,1092,69,6,Steiermark,1,70,1.4
936,86836,2020-07-03,2,0,1,32,7,Tirol,2,32,0.0
937,29720,2020-07-03,0,0,99,18,8,Vorarlberg,0,18,0.0
938,171663,2020-07-03,26,4,2099,289,9,Wien,30,293,1.4
939,635505,2020-07-03,65,7,7269,698,10,Alle,72,705,1.0
940,17090,2020-07-04,2,0,403,10,1,Burgenland,2,10,0.0
941,28859,2020-07-04,1,0,79,40,2,Kärnten,1,40,0.0
942,115376,2020-07-04,11,2,1669,168,3,Niederösterreich,13,170,1.2
943,83855,2020-07-04,19,0,1858,75,4,Oberösterreich,19,75,0.0
944,39269,2020-07-04,4,0,36,0,5,Salzburg,4,0,0.0
945,67132,2020-07-04,1,1,1185,69,6,Steiermark,2,70,1.4
946,87428,2020-07-04,2,0,1,32,7,Tirol,2,32,0.0
947,29720,2020-07-04,0,0,100,22,8,Vorarlberg,0,22,0.0
948,173950,2020-07-04,20,5,2291,278,9,Wien,25,283,1.8
949,642679,2020-07-04,60,8,7622,694,10,Alle,68,702,1.1
950,17376,2020-07-05,2,0,426,13,1,Burgenland,2,13,0.0
951,29002,2020-07-05,2,0,78,40,2,Kärnten,2,40,0.0
952,116784,2020-07-05,11,2,1924,168,3,Niederösterreich,13,170,1.2
953,83855,2020-07-05,19,0,1858,75,4,Oberösterreich,19,75,0.0
954,39455,2020-07-05,2,0,38,0,5,Salzburg,2,0,0.0
955,67612,2020-07-05,1,1,1645,70,6,Steiermark,2,71,1.4
956,87843,2020-07-05,2,0,1,32,7,Tirol,2,32,0.0
957,30624,2020-07-05,0,0,100,22,8,Vorarlberg,0,22,0.0
958,175253,2020-07-05,23,7,2452,285,9,Wien,30,292,2.4
959,647804,2020-07-05,62,10,8522,705,10,Alle,72,715,1.4
960,17432,2020-07-06,2,0,392,12,1,Burgenland,2,12,0.0
961,29257,2020-07-06,2,0,78,40,2,Kärnten,2,40,0.0
962,117939,2020-07-06,13,2,2677,168,3,Niederösterreich,15,170,1.2
963,86352,2020-07-06,22,1,2544,82,4,Oberösterreich,23,83,1.2
964,39596,2020-07-06,2,0,38,0,5,Salzburg,2,0,0.0
965,68021,2020-07-06,1,1,1752,79,6,Steiermark,2,80,1.2
966,88265,2020-07-06,2,0,1,45,7,Tirol,2,45,0.0
967,30776,2020-07-06,0,0,100,22,8,Vorarlberg,0,22,0.0
968,176467,2020-07-06,23,7,2527,287,9,Wien,30,294,2.4
969,654105,2020-07-06,67,11,10109,735,10,Alle,78,746,1.5
970,17535,2020-07-07,2,0,368,12,1,Burgenland,2,12,0.0
971,29631,2020-07-07,2,0,78,40,2,Kärnten,2,40,0.0
972,119295,2020-07-07,11,2,2666,168,3,Niederösterreich,13,170,1.2
973,87381,2020-07-07,19,0,2011,75,4,Oberösterreich,19,75,0.0
974,39881,2020-07-07,2,0,38,0,5,Salzburg,2,0,0.0
975,68290,2020-07-07,1,1,1389,83,6,Steiermark,2,84,1.2
976,88866,2020-07-07,2,0,4,35,7,Tirol,2,35,0.0
977,31142,2020-07-07,0,0,100,24,8,Vorarlberg,0,24,0.0
978,178128,2020-07-07,42,7,2332,290,9,Wien,49,297,2.4
979,660149,2020-07-07,81,10,8986,727,10,Alle,91,737,1.4
980,17797,2020-07-08,2,0,362,11,1,Burgenland,2,11,0.0
981,30017,2020-07-08,1,0,79,40,2,Kärnten,1,40,0.0
982,120739,2020-07-08,11,3,1882,167,3,Niederösterreich,14,170,1.8
983,89336,2020-07-08,23,0,1877,78,4,Oberösterreich,23,78,0.0
984,40087,2020-07-08,2,0,38,0,5,Salzburg,2,0,0.0
985,69267,2020-07-08,2,1,1197,88,6,Steiermark,3,89,1.1
986,89575,2020-07-08,2,0,4,35,7,Tirol,2,35,0.0
987,31345,2020-07-08,1,0,99,18,8,Vorarlberg,1,18,0.0
988,180057,2020-07-08,22,7,2151,259,9,Wien,29,266,2.6
989,668220,2020-07-08,66,11,7689,696,10,Alle,77,707,1.6
990,17961,2020-07-09,2,0,356,9,1,Burgenland,2,9,0.0
991,30442,2020-07-09,1,0,79,40,2,Kärnten,1,40,0.0
992,122194,2020-07-09,8,3,1679,167,3,Niederösterreich,11,170,1.8
993,91305,2020-07-09,23,0,1830,68,4,Oberösterreich,23,68,0.0
994,40283,2020-07-09,2,0,38,0,5,Salzburg,2,0,0.0
995,70212,2020-07-09,2,1,1075,85,6,Steiermark,3,86,1.2
996,90236,2020-07-09,2,0,1,29,7,Tirol,2,29,0.0
997,31456,2020-07-09,1,0,83,21,8,Vorarlberg,1,21,0.0
998,181638,2020-07-09,25,8,2019,252,9,Wien,33,260,3.1
999,675727,2020-07-09,66,12,7160,671,10,Alle,78,683,1.8
1000,18191,2020-07-10,3,0,376,12,1,Burgenland,3,12,0.0
1001,30759,2020-07-10,1,0,79,40,2,Kärnten,1,40,0.0
1002,123611,2020-07-10,9,3,1575,167,3,Niederösterreich,12,170,1.8
1003,93251,2020-07-10,25,1,2011,68,4,Oberösterreich,26,69,1.4
1004,40513,2020-07-10,4,0,38,0,5,Salzburg,4,0,0.0
1005,70837,2020-07-10,2,1,1057,85,6,Steiermark,3,86,1.2
1006,90882,2020-07-10,2,0,1,26,7,Tirol,2,26,0.0
1007,31983,2020-07-10,1,0,83,25,8,Vorarlberg,1,25,0.0
1008,183457,2020-07-10,24,4,2014,270,9,Wien,28,274,1.5
1009,683484,2020-07-10,71,9,7234,693,10,Alle,80,702,1.3
1010,18315,2020-07-11,2,0,460,12,1,Burgenland,2,12,0.0
1011,31067,2020-07-11,0,0,80,40,2,Kärnten,0,40,0.0
1012,125019,2020-07-11,9,3,1647,167,3,Niederösterreich,12,170,1.8
1013,95154,2020-07-11,25,1,2011,68,4,Oberösterreich,26,69,1.4
1014,41142,2020-07-11,4,0,38,0,5,Salzburg,4,0,0.0
1015,71324,2020-07-11,1,1,1158,87,6,Steiermark,2,88,1.1
1016,91513,2020-07-11,2,0,1,26,7,Tirol,2,26,0.0
1017,32195,2020-07-11,1,0,83,21,8,Vorarlberg,1,21,0.0
1018,185980,2020-07-11,24,4,2252,270,9,Wien,28,274,1.5
1019,691709,2020-07-11,68,9,7730,691,10,Alle,77,700,1.3
1020,18445,2020-07-12,2,0,472,15,1,Burgenland,2,15,0.0
1021,31472,2020-07-12,0,0,80,40,2,Kärnten,0,40,0.0
1022,126405,2020-07-12,11,3,1835,167,3,Niederösterreich,14,170,1.8
1023,96271,2020-07-12,25,1,2011,68,4,Oberösterreich,26,69,1.4
1024,41376,2020-07-12,2,0,38,0,5,Salzburg,2,0,0.0
1025,71594,2020-07-12,2,1,1543,96,6,Steiermark,3,97,1.0
1026,91980,2020-07-12,2,0,1,26,7,Tirol,2,26,0.0
1027,32195,2020-07-12,1,0,83,21,8,Vorarlberg,1,21,0.0
1028,187002,2020-07-12,28,5,2386,283,9,Wien,33,288,1.7
1029,696740,2020-07-12,73,10,8449,716,10,Alle,83,726,1.4
1030,18514,2020-07-13,2,0,396,15,1,Burgenland,2,15,0.0
1031,31555,2020-07-13,1,0,79,40,2,Kärnten,1,40,0.0
1032,127866,2020-07-13,10,3,2711,167,3,Niederösterreich,13,170,1.8
1033,97257,2020-07-13,28,0,2699,80,4,Oberösterreich,28,80,0.0
1034,41494,2020-07-13,3,0,38,0,5,Salzburg,3,0,0.0
1035,71731,2020-07-13,2,1,1643,103,6,Steiermark,3,104,1.0
1036,92289,2020-07-13,3,0,2,41,7,Tirol,3,41,0.0
1037,32908,2020-07-13,1,0,83,21,8,Vorarlberg,1,21,0.0
1038,187002,2020-07-13,24,4,2455,236,9,Wien,28,240,1.7
1039,700616,2020-07-13,74,8,10106,703,10,Alle,82,711,1.1
1040,18589,2020-07-14,1,0,351,15,1,Burgenland,1,15,0.0
1041,32150,2020-07-14,1,0,79,40,2,Kärnten,1,40,0.0
1042,129302,2020-07-14,9,3,2710,167,3,Niederösterreich,12,170,1.8
1043,98071,2020-07-14,27,1,2141,79,4,Oberösterreich,28,80,1.2
1044,41821,2020-07-14,3,0,38,0,5,Salzburg,3,0,0.0
1045,72312,2020-07-14,3,1,1246,98,6,Steiermark,4,99,1.0
1046,92897,2020-07-14,2,0,5,29,7,Tirol,2,29,0.0
1047,33051,2020-07-14,1,0,83,21,8,Vorarlberg,1,21,0.0
1048,189935,2020-07-14,27,4,2418,295,9,Wien,31,299,1.3
1049,708128,2020-07-14,74,9,9071,744,10,Alle,83,753,1.2
1050,18750,2020-07-15,1,0,353,14,1,Burgenland,1,14,0.0
1051,32582,2020-07-15,1,0,79,40,2,Kärnten,1,40,0.0
1052,130566,2020-07-15,8,3,1890,167,3,Niederösterreich,11,170,1.8
1053,99648,2020-07-15,28,1,1991,66,4,Oberösterreich,29,67,1.5
1054,42141,2020-07-15,4,0,36,0,5,Salzburg,4,0,0.0
1055,73164,2020-07-15,3,1,1020,85,6,Steiermark,4,86,1.2
1056,93834,2020-07-15,2,0,7,31,7,Tirol,2,31,0.0
1057,33349,2020-07-15,1,0,83,22,8,Vorarlberg,1,22,0.0
1058,192259,2020-07-15,38,5,2310,291,9,Wien,43,296,1.7
1059,716293,2020-07-15,86,10,7769,716,10,Alle,96,726,1.4
1060,18906,2020-07-16,1,0,367,15,1,Burgenland,1,15,0.0
1061,33066,2020-07-16,1,0,79,40,2,Kärnten,1,40,0.0
1062,131566,2020-07-16,8,3,1595,167,3,Niederösterreich,11,170,1.8
1063,101372,2020-07-16,26,1,2013,69,4,Oberösterreich,27,70,1.4
1064,42348,2020-07-16,4,0,36,0,5,Salzburg,4,0,0.0
1065,73856,2020-07-16,4,1,982,77,6,Steiermark,5,78,1.3
1066,94415,2020-07-16,2,0,3,32,7,Tirol,2,32,0.0
1067,36045,2020-07-16,1,0,83,21,8,Vorarlberg,1,21,0.0
1068,194771,2020-07-16,36,6,2063,294,9,Wien,42,300,2.0
1069,726345,2020-07-16,83,11,7221,715,10,Alle,94,726,1.5
1070,19010,2020-07-17,1,0,346,16,1,Burgenland,1,16,0.0
1071,33511,2020-07-17,1,0,79,40,2,Kärnten,1,40,0.0
1072,132685,2020-07-17,10,3,1432,167,3,Niederösterreich,13,170,1.8
1073,103243,2020-07-17,29,1,2027,71,4,Oberösterreich,30,72,1.4
1074,42849,2020-07-17,3,0,37,0,5,Salzburg,3,0,0.0
1075,74702,2020-07-17,4,1,1058,70,6,Steiermark,5,71,1.4
1076,95159,2020-07-17,2,0,2,34,7,Tirol,2,34,0.0
1077,36484,2020-07-17,1,0,83,23,8,Vorarlberg,1,23,0.0
1078,196770,2020-07-17,37,6,2074,308,9,Wien,43,314,1.9
1079,734413,2020-07-17,88,11,7138,729,10,Alle,99,740,1.5
1080,19092,2020-07-18,0,0,410,17,1,Burgenland,0,17,0.0
1081,34139,2020-07-18,1,0,78,40,2,Kärnten,1,40,0.0
1082,134884,2020-07-18,13,4,1573,166,3,Niederösterreich,17,170,2.4
1083,104668,2020-07-18,29,1,2027,71,4,Oberösterreich,30,72,1.4
1084,43108,2020-07-18,4,0,37,0,5,Salzburg,4,0,0.0
1085,75367,2020-07-18,4,1,1054,88,6,Steiermark,5,89,1.1
1086,95669,2020-07-18,1,0,2,34,7,Tirol,1,34,0.0
1087,37165,2020-07-18,1,0,83,21,8,Vorarlberg,1,21,0.0
1088,198998,2020-07-18,34,5,2324,322,9,Wien,39,327,1.5
1089,743090,2020-07-18,87,11,7588,759,10,Alle,98,770,1.4
1090,19195,2020-07-19,0,0,433,15,1,Burgenland,0,15,0.0
1091,34397,2020-07-19,1,0,79,40,2,Kärnten,1,40,0.0
1092,136543,2020-07-19,14,4,1749,166,3,Niederösterreich,18,170,2.4
1093,105661,2020-07-19,29,1,2027,71,4,Oberösterreich,30,72,1.4
1094,43377,2020-07-19,4,1,37,0,5,Salzburg,5,1,100.0
1095,75696,2020-07-19,3,1,1442,101,6,Steiermark,4,102,1.0
1096,96014,2020-07-19,1,0,2,34,7,Tirol,1,34,0.0
1097,37568,2020-07-19,1,0,83,21,8,Vorarlberg,1,21,0.0
1098,200218,2020-07-19,32,7,2421,327,9,Wien,39,334,2.1
1099,748669,2020-07-19,85,14,8273,775,10,Alle,99,789,1.8
1100,19235,2020-07-20,0,0,394,16,1,Burgenland,0,16,0.0
1101,34446,2020-07-20,1,0,79,40,2,Kärnten,1,40,0.0
1102,137720,2020-07-20,13,5,2576,165,3,Niederösterreich,18,170,2.9
1103,106520,2020-07-20,38,2,2646,87,4,Oberösterreich,40,89,2.2
1104,43520,2020-07-20,6,1,34,1,5,Salzburg,7,2,50.0
1105,75828,2020-07-20,1,1,1530,106,6,Steiermark,2,107,0.9
1106,141811,2020-07-20,1,0,2,34,7,Tirol,1,34,0.0
1107,38148,2020-07-20,1,0,83,21,8,Vorarlberg,1,21,0.0
1108,201208,2020-07-20,35,7,2406,315,9,Wien,42,322,2.2
1109,798436,2020-07-20,96,16,9750,785,10,Alle,112,801,2.0
1110,19316,2020-07-21,0,0,362,15,1,Burgenland,0,15,0.0
1111,35068,2020-07-21,1,0,79,40,2,Kärnten,1,40,0.0
1112,139417,2020-07-21,13,5,2523,165,3,Niederösterreich,18,170,2.9
1113,107834,2020-07-21,31,3,2150,82,4,Oberösterreich,34,85,3.5
1114,43947,2020-07-21,6,1,34,11,5,Salzburg,7,12,8.3
1115,76205,2020-07-21,3,1,1153,95,6,Steiermark,4,96,1.0
1116,142426,2020-07-21,1,0,0,37,7,Tirol,1,37,0.0
1117,38436,2020-07-21,1,1,83,24,8,Vorarlberg,2,25,4.0
1118,202951,2020-07-21,40,7,2368,303,9,Wien,47,310,2.3
1119,805600,2020-07-21,96,18,8752,772,10,Alle,114,790,2.3
1120,19410,2020-07-22,0,0,353,18,1,Burgenland,0,18,0.0
1121,35544,2020-07-22,2,0,78,40,2,Kärnten,2,40,0.0
1122,141159,2020-07-22,12,5,1713,165,3,Niederösterreich,17,170,2.9
1123,109445,2020-07-22,28,2,1988,72,4,Oberösterreich,30,74,2.7
1124,44385,2020-07-22,6,1,34,11,5,Salzburg,7,12,8.3
1125,76777,2020-07-22,5,1,985,99,6,Steiermark,6,100,1.0
1126,143530,2020-07-22,1,0,0,31,7,Tirol,1,31,0.0
1127,38482,2020-07-22,1,1,82,25,8,Vorarlberg,2,26,3.8
1128,205949,2020-07-22,38,8,2219,292,9,Wien,46,300,2.7
1129,814681,2020-07-22,93,18,7452,753,10,Alle,111,771,2.3
1130,19508,2020-07-23,1,0,366,16,1,Burgenland,1,16,0.0
1131,35951,2020-07-23,2,0,78,40,2,Kärnten,2,40,0.0
1132,142839,2020-07-23,10,4,1460,166,3,Niederösterreich,14,170,2.4
1133,110797,2020-07-23,27,2,1939,81,4,Oberösterreich,29,83,2.4
1134,44861,2020-07-23,5,1,35,11,5,Salzburg,6,12,8.3
1135,77293,2020-07-23,4,1,1031,92,6,Steiermark,5,93,1.1
1136,144886,2020-07-23,1,0,0,26,7,Tirol,1,26,0.0
1137,38635,2020-07-23,2,1,82,26,8,Vorarlberg,3,27,3.7
1138,211261,2020-07-23,35,6,2152,282,9,Wien,41,288,2.1
1139,826031,2020-07-23,87,15,7143,740,10,Alle,102,755,2.0
1140,19624,2020-07-24,0,0,383,11,1,Burgenland,0,11,0.0
1141,36994,2020-07-24,2,0,78,40,2,Kärnten,2,40,0.0
1142,144361,2020-07-24,10,4,1391,166,3,Niederösterreich,14,170,2.4
1143,112100,2020-07-24,26,2,2052,81,4,Oberösterreich,28,83,2.4
1144,45191,2020-07-24,5,1,35,11,5,Salzburg,6,12,8.3
1145,77781,2020-07-24,5,2,850,95,6,Steiermark,7,97,2.1
1146,146017,2020-07-24,2,0,0,37,7,Tirol,2,37,0.0
1147,38944,2020-07-24,3,1,81,25,8,Vorarlberg,4,26,3.8
1148,212829,2020-07-24,33,7,2159,281,9,Wien,40,288,2.4
1149,833841,2020-07-24,86,17,7029,747,10,Alle,103,764,2.2
1150,19707,2020-07-25,0,0,448,9,1,Burgenland,0,9,0.0
1151,37285,2020-07-25,0,0,80,40,2,Kärnten,0,40,0.0
1152,145957,2020-07-25,9,4,1372,166,3,Niederösterreich,13,170,2.4
1153,113240,2020-07-25,26,2,2052,81,4,Oberösterreich,28,83,2.4
1154,45503,2020-07-25,5,1,35,11,5,Salzburg,6,12,8.3
1155,78173,2020-07-25,5,3,1013,90,6,Steiermark,8,93,3.2
1156,147075,2020-07-25,2,0,0,37,7,Tirol,2,37,0.0
1157,39235,2020-07-25,3,1,81,25,8,Vorarlberg,4,26,3.8
1158,214715,2020-07-25,35,5,2366,289,9,Wien,40,294,1.7
1159,840890,2020-07-25,85,16,7447,748,10,Alle,101,764,2.1
1160,19815,2020-07-26,0,0,460,9,1,Burgenland,0,9,0.0
1161,37364,2020-07-26,0,0,80,40,2,Kärnten,0,40,0.0
1162,147253,2020-07-26,7,4,1698,166,3,Niederösterreich,11,170,2.4
1163,114297,2020-07-26,26,2,2052,81,4,Oberösterreich,28,83,2.4
1164,45607,2020-07-26,6,1,34,11,5,Salzburg,7,12,8.3
1165,78346,2020-07-26,5,2,1464,112,6,Steiermark,7,114,1.8
1166,148567,2020-07-26,2,0,0,37,7,Tirol,2,37,0.0
1167,41217,2020-07-26,3,1,81,25,8,Vorarlberg,4,26,3.8
1168,215432,2020-07-26,33,5,2487,304,9,Wien,38,309,1.6
1169,847898,2020-07-26,82,15,8356,785,10,Alle,97,800,1.9
1170,19852,2020-07-27,0,0,411,11,1,Burgenland,0,11,0.0
1171,37373,2020-07-27,0,0,80,40,2,Kärnten,0,40,0.0
1172,148592,2020-07-27,8,4,2498,166,3,Niederösterreich,12,170,2.4
1173,115229,2020-07-27,22,3,3498,99,4,Oberösterreich,25,102,2.9
1174,45919,2020-07-27,6,1,34,11,5,Salzburg,7,12,8.3
1175,78499,2020-07-27,3,1,1543,109,6,Steiermark,4,110,0.9
1176,149689,2020-07-27,2,0,0,37,7,Tirol,2,37,0.0
1177,41326,2020-07-27,3,1,81,25,8,Vorarlberg,4,26,3.8
1178,216690,2020-07-27,35,6,2517,287,9,Wien,41,293,2.0
1179,853169,2020-07-27,79,16,10662,785,10,Alle,95,801,2.0
1180,19918,2020-07-28,0,0,361,12,1,Burgenland,0,12,0.0
1181,37748,2020-07-28,0,0,80,40,2,Kärnten,0,40,0.0
1182,149905,2020-07-28,8,4,2500,166,3,Niederösterreich,12,170,2.4
1183,117030,2020-07-28,18,3,2706,77,4,Oberösterreich,21,80,3.8
1184,46321,2020-07-28,6,1,34,11,5,Salzburg,7,12,8.3
1185,78947,2020-07-28,5,1,1181,110,6,Steiermark,6,111,0.9
1186,151045,2020-07-28,2,0,0,37,7,Tirol,2,37,0.0
1187,41482,2020-07-28,3,0,81,30,8,Vorarlberg,3,30,0.0
1188,218810,2020-07-28,32,6,2441,281,9,Wien,38,287,2.1
1189,861206,2020-07-28,74,15,9384,764,10,Alle,89,779,1.9
1190,19997,2020-07-29,0,1,344,11,1,Burgenland,1,12,8.3
1191,38234,2020-07-29,0,0,80,40,2,Kärnten,0,40,0.0
1192,151529,2020-07-29,9,4,1680,166,3,Niederösterreich,13,170,2.4
1193,118488,2020-07-29,17,4,2127,76,4,Oberösterreich,21,80,5.0
1194,46753,2020-07-29,6,1,34,11,5,Salzburg,7,12,8.3
1195,79847,2020-07-29,6,0,1035,106,6,Steiermark,6,106,0.0
1196,152814,2020-07-29,1,1,8,32,7,Tirol,2,33,3.0
1197,41787,2020-07-29,3,0,81,30,8,Vorarlberg,3,30,0.0
1198,221153,2020-07-29,32,9,2170,274,9,Wien,41,283,3.2
1199,870602,2020-07-29,74,20,7559,746,10,Alle,94,766,2.6
1200,20114,2020-07-30,3,0,369,9,1,Burgenland,3,9,0.0
1201,38523,2020-07-30,0,0,80,40,2,Kärnten,0,40,0.0
1202,153254,2020-07-30,8,4,1530,166,3,Niederösterreich,12,170,2.4
1203,120416,2020-07-30,20,3,2071,73,4,Oberösterreich,23,76,3.9
1204,47098,2020-07-30,6,1,34,11,5,Salzburg,7,12,8.3
1205,80488,2020-07-30,7,0,1019,82,6,Steiermark,7,82,0.0
1206,154224,2020-07-30,2,1,2,31,7,Tirol,3,32,3.1
1207,42285,2020-07-30,3,0,81,27,8,Vorarlberg,3,27,0.0
1208,223634,2020-07-30,38,9,2079,277,9,Wien,47,286,3.1
1209,880036,2020-07-30,87,18,7265,716,10,Alle,105,734,2.5
1210,20307,2020-07-31,1,1,340,17,1,Burgenland,2,18,5.6
1211,40213,2020-07-31,0,0,80,40,2,Kärnten,0,40,0.0
1212,154937,2020-07-31,6,4,1428,166,3,Niederösterreich,10,170,2.4
1213,121855,2020-07-31,19,3,2152,73,4,Oberösterreich,22,76,3.9
1214,47528,2020-07-31,5,1,35,11,5,Salzburg,6,12,8.3
1215,81079,2020-07-31,7,0,1017,86,6,Steiermark,7,86,0.0
1216,155954,2020-07-31,4,0,0,34,7,Tirol,4,34,0.0
1217,43078,2020-07-31,3,0,81,30,8,Vorarlberg,3,30,0.0
1218,225510,2020-07-31,39,7,2209,280,9,Wien,46,287,2.4
1219,890461,2020-07-31,84,16,7342,737,10,Alle,100,753,2.1
1220,20405,2020-08-01,1,0,407,16,1,Burgenland,1,16,0.0
1221,40467,2020-08-01,0,0,80,40,2,Kärnten,0,40,0.0
1222,156404,2020-08-01,7,3,1494,167,3,Niederösterreich,10,170,1.8
1223,123029,2020-08-01,19,3,2152,73,4,Oberösterreich,22,76,3.9
1224,47823,2020-08-01,5,1,35,11,5,Salzburg,6,12,8.3
1225,81606,2020-08-01,4,3,1169,87,6,Steiermark,7,90,3.3
1226,156954,2020-08-01,4,0,0,34,7,Tirol,4,34,0.0
1227,43834,2020-08-01,2,0,82,28,8,Vorarlberg,2,28,0.0
1228,227297,2020-08-01,28,9,2459,296,9,Wien,37,305,3.0
1229,897819,2020-08-01,70,19,7878,752,10,Alle,89,771,2.5
1230,20556,2020-08-02,0,0,422,13,1,Burgenland,0,13,0.0
1231,40642,2020-08-02,0,0,80,40,2,Kärnten,0,40,0.0
1232,157710,2020-08-02,6,3,1715,167,3,Niederösterreich,9,170,1.8
1233,123630,2020-08-02,19,3,2152,73,4,Oberösterreich,22,76,3.9
1234,48002,2020-08-02,7,0,33,13,5,Salzburg,7,13,0.0
1235,81978,2020-08-02,4,3,1557,80,6,Steiermark,7,83,3.6
1236,159552,2020-08-02,4,0,0,34,7,Tirol,4,34,0.0
1237,44822,2020-08-02,2,0,82,28,8,Vorarlberg,2,28,0.0
1238,228422,2020-08-02,31,11,2553,294,9,Wien,42,305,3.6
1239,905314,2020-08-02,73,20,8594,742,10,Alle,93,762,2.6
1240,20594,2020-08-03,0,0,392,15,1,Burgenland,0,15,0.0
1241,40737,2020-08-03,0,0,80,40,2,Kärnten,0,40,0.0
1242,158772,2020-08-03,9,3,2560,167,3,Niederösterreich,12,170,1.8
1243,124140,2020-08-03,25,1,2876,87,4,Oberösterreich,26,88,1.1
1244,48135,2020-08-03,8,0,32,13,5,Salzburg,8,13,0.0
1245,82113,2020-08-03,7,5,1634,99,6,Steiermark,12,104,4.8
1246,161127,2020-08-03,4,0,0,34,7,Tirol,4,34,0.0
1247,45070,2020-08-03,2,0,82,28,8,Vorarlberg,2,28,0.0
1248,229749,2020-08-03,37,12,2591,311,9,Wien,49,323,3.7
1249,910437,2020-08-03,92,21,10247,794,10,Alle,113,815,2.6
1250,20737,2020-08-04,0,0,330,14,1,Burgenland,0,14,0.0
1251,41012,2020-08-04,0,0,80,40,2,Kärnten,0,40,0.0
1252,160298,2020-08-04,11,3,2562,167,3,Niederösterreich,14,170,1.8
1253,125264,2020-08-04,21,5,2333,85,4,Oberösterreich,26,90,5.6
1254,48135,2020-08-04,8,0,32,13,5,Salzburg,8,13,0.0
1255,82485,2020-08-04,6,5,1246,97,6,Steiermark,11,102,4.9
1256,162039,2020-08-04,4,0,2,40,7,Tirol,4,40,0.0
1257,45312,2020-08-04,1,0,83,21,8,Vorarlberg,1,21,0.0
1258,231496,2020-08-04,33,10,2317,322,9,Wien,43,332,3.0
1259,916778,2020-08-04,84,23,8985,799,10,Alle,107,822,2.8
1260,20832,2020-08-05,2,0,315,10,1,Burgenland,2,10,0.0
1261,41384,2020-08-05,0,0,80,40,2,Kärnten,0,40,0.0
1262,161899,2020-08-05,11,3,1811,167,3,Niederösterreich,14,170,1.8
1263,126151,2020-08-05,20,6,2210,86,4,Oberösterreich,26,92,6.5
1264,48929,2020-08-05,8,0,32,2,5,Salzburg,8,2,0.0
1265,83066,2020-08-05,7,5,1174,87,6,Steiermark,12,92,5.4
1266,163087,2020-08-05,4,0,3,35,7,Tirol,4,35,0.0
1267,45583,2020-08-05,1,0,83,22,8,Vorarlberg,1,22,0.0
1268,232971,2020-08-05,37,11,2217,269,9,Wien,48,280,3.9
1269,923902,2020-08-05,90,25,7925,718,10,Alle,115,743,3.4
1270,21276,2020-08-06,1,0,326,10,1,Burgenland,1,10,0.0
1271,41686,2020-08-06,0,0,80,40,2,Kärnten,0,40,0.0
1272,163516,2020-08-06,14,3,1627,167,3,Niederösterreich,17,170,1.8
1273,127386,2020-08-06,23,6,2051,87,4,Oberösterreich,29,93,6.5
1274,49363,2020-08-06,8,0,32,2,5,Salzburg,8,2,0.0
1275,83891,2020-08-06,6,5,1076,84,6,Steiermark,11,89,5.6
1276,163930,2020-08-06,5,0,1,31,7,Tirol,5,31,0.0
1277,46027,2020-08-06,1,0,83,22,8,Vorarlberg,1,22,0.0
1278,240200,2020-08-06,34,11,2033,304,9,Wien,45,315,3.5
1279,937275,2020-08-06,92,25,7309,747,10,Alle,117,772,3.2
1280,21705,2020-08-07,1,0,365,10,1,Burgenland,1,10,0.0
1281,43737,2020-08-07,1,0,79,40,2,Kärnten,1,40,0.0
1282,165202,2020-08-07,17,3,1537,167,3,Niederösterreich,20,170,1.8
1283,128774,2020-08-07,22,5,2204,82,4,Oberösterreich,27,87,5.7
1284,49691,2020-08-07,7,0,33,2,5,Salzburg,7,2,0.0
1285,84540,2020-08-07,6,5,1032,78,6,Steiermark,11,83,6.0
1286,164779,2020-08-07,3,0,2,34,7,Tirol,3,34,0.0
1287,46759,2020-08-07,1,0,83,25,8,Vorarlberg,1,25,0.0
1288,242118,2020-08-07,35,12,2015,303,9,Wien,47,315,3.8
1289,947305,2020-08-07,93,25,7350,741,10,Alle,118,766,3.3
1290,21980,2020-08-08,1,0,421,10,1,Burgenland,1,10,0.0
1291,44062,2020-08-08,2,0,78,40,2,Kärnten,2,40,0.0
1292,166733,2020-08-08,15,3,1593,167,3,Niederösterreich,18,170,1.8
1293,129690,2020-08-08,22,5,2204,82,4,Oberösterreich,27,87,5.7
1294,49928,2020-08-08,8,0,32,2,5,Salzburg,8,2,0.0
1295,85127,2020-08-08,7,6,1048,94,6,Steiermark,13,100,6.0
1296,166324,2020-08-08,3,0,2,34,7,Tirol,3,34,0.0
1297,47307,2020-08-08,1,0,83,25,8,Vorarlberg,1,25,0.0
1298,244088,2020-08-08,37,10,2195,312,9,Wien,47,322,3.1
1299,955239,2020-08-08,96,24,7656,766,10,Alle,120,790,3.0
1300,22088,2020-08-09,2,0,428,12,1,Burgenland,2,12,0.0
1301,44194,2020-08-09,3,0,77,40,2,Kärnten,3,40,0.0
1302,168323,2020-08-09,14,4,1772,166,3,Niederösterreich,18,170,2.4
1303,130335,2020-08-09,22,5,2204,82,4,Oberösterreich,27,87,5.7
1304,50114,2020-08-09,8,0,32,2,5,Salzburg,8,2,0.0
1305,85363,2020-08-09,10,4,1496,110,6,Steiermark,14,114,3.5
1306,168206,2020-08-09,3,0,2,34,7,Tirol,3,34,0.0
1307,47789,2020-08-09,1,0,83,25,8,Vorarlberg,1,25,0.0
1308,245456,2020-08-09,36,9,2317,319,9,Wien,45,328,2.7
1309,961868,2020-08-09,99,22,8411,790,10,Alle,121,812,2.7
1310,22160,2020-08-10,2,0,371,14,1,Burgenland,2,14,0.0
1311,44344,2020-08-10,2,0,77,40,2,Kärnten,2,40,0.0
1312,169632,2020-08-10,16,5,2599,165,3,Niederösterreich,21,170,2.9
1313,130632,2020-08-10,18,5,2814,98,4,Oberösterreich,23,103,4.9
1314,50305,2020-08-10,4,0,36,2,5,Salzburg,4,2,0.0
1315,85490,2020-08-10,8,5,1573,114,6,Steiermark,13,119,4.2
1316,168332,2020-08-10,6,0,4,37,7,Tirol,6,37,0.0
1317,48463,2020-08-10,1,0,83,25,8,Vorarlberg,1,25,0.0
1318,246400,2020-08-10,35,9,2384,316,9,Wien,44,325,2.8
1319,965758,2020-08-10,92,24,9941,811,10,Alle,116,835,2.9
1320,23699,2020-08-11,2,0,343,13,1,Burgenland,2,13,0.0
1321,44636,2020-08-11,3,0,77,40,2,Kärnten,3,40,0.0
1322,171181,2020-08-11,18,3,2594,167,3,Niederösterreich,21,170,1.8
1323,131654,2020-08-11,11,7,2360,90,4,Oberösterreich,18,97,7.2
1324,50625,2020-08-11,4,0,36,13,5,Salzburg,4,13,0.0
1325,86433,2020-08-11,9,5,1335,99,6,Steiermark,14,104,4.8
1326,169080,2020-08-11,6,0,3,29,7,Tirol,6,29,0.0
1327,48798,2020-08-11,1,0,83,23,8,Vorarlberg,1,23,0.0
1328,248402,2020-08-11,40,10,2260,308,9,Wien,50,318,3.1
1329,974508,2020-08-11,94,25,9091,782,10,Alle,119,807,3.1
1330,23905,2020-08-12,1,0,326,10,1,Burgenland,1,10,0.0
1331,45082,2020-08-12,3,0,77,40,2,Kärnten,3,40,0.0
1332,172842,2020-08-12,18,4,1755,166,3,Niederösterreich,22,170,2.4
1333,132687,2020-08-12,12,6,2220,89,4,Oberösterreich,18,95,6.3
1334,50992,2020-08-12,3,0,41,2,5,Salzburg,3,2,0.0
1335,87405,2020-08-12,7,5,1216,79,6,Steiermark,12,84,6.0
1336,170044,2020-08-12,6,0,2,34,7,Tirol,6,34,0.0
1337,48899,2020-08-12,2,0,82,20,8,Vorarlberg,2,20,0.0
1338,251162,2020-08-12,41,10,2073,297,9,Wien,51,307,3.3
1339,983018,2020-08-12,93,25,7792,737,10,Alle,118,762,3.3
1340,24446,2020-08-13,1,0,326,10,1,Burgenland,1,10,0.0
1341,45427,2020-08-13,3,0,77,40,2,Kärnten,3,40,0.0
1342,174574,2020-08-13,18,3,1563,167,3,Niederösterreich,21,170,1.8
1343,133497,2020-08-13,11,5,2169,89,4,Oberösterreich,16,94,5.3
1344,51374,2020-08-13,3,0,41,2,5,Salzburg,3,2,0.0
1345,88320,2020-08-13,5,5,1212,77,6,Steiermark,10,82,6.1
1346,171150,2020-08-13,7,0,3,34,7,Tirol,7,34,0.0
1347,49350,2020-08-13,2,0,82,24,8,Vorarlberg,2,24,0.0
1348,253370,2020-08-13,42,9,1964,303,9,Wien,51,312,2.9
1349,991508,2020-08-13,92,22,7437,746,10,Alle,114,768,2.9
1350,24590,2020-08-14,1,0,324,15,1,Burgenland,1,15,0.0
1351,47321,2020-08-14,3,0,77,40,2,Kärnten,3,40,0.0
1352,176256,2020-08-14,16,3,1454,167,3,Niederösterreich,19,170,1.8
1353,138419,2020-08-14,13,5,2241,81,4,Oberösterreich,18,86,5.8
1354,51575,2020-08-14,4,0,40,2,5,Salzburg,4,2,0.0
1355,89066,2020-08-14,7,3,1137,83,6,Steiermark,10,86,3.5
1356,172650,2020-08-14,6,0,4,28,7,Tirol,6,28,0.0
1357,50185,2020-08-14,2,0,82,28,8,Vorarlberg,2,28,0.0
1358,253370,2020-08-14,39,8,1918,298,9,Wien,47,306,2.6
1359,1003432,2020-08-14,91,19,7277,742,10,Alle,110,761,2.5
1360,25055,2020-08-15,0,0,383,13,1,Burgenland,0,13,0.0
1361,47714,2020-08-15,2,0,78,40,2,Kärnten,2,40,0.0
1362,177789,2020-08-15,14,4,1553,166,3,Niederösterreich,18,170,2.4
1363,139400,2020-08-15,13,5,2241,81,4,Oberösterreich,18,86,5.8
1364,51715,2020-08-15,4,0,40,2,5,Salzburg,4,2,0.0
1365,89433,2020-08-15,6,3,1137,83,6,Steiermark,9,86,3.5
1366,173799,2020-08-15,6,0,4,28,7,Tirol,6,28,0.0
1367,51079,2020-08-15,1,0,83,23,8,Vorarlberg,1,23,0.0
1368,253370,2020-08-15,37,9,2084,312,9,Wien,46,321,2.8
1369,1009354,2020-08-15,83,21,7603,748,10,Alle,104,769,2.7
1370,25202,2020-08-16,0,0,407,16,1,Burgenland,0,16,0.0
1371,47873,2020-08-16,2,0,78,40,2,Kärnten,2,40,0.0
1372,179145,2020-08-16,14,4,1780,166,3,Niederösterreich,18,170,2.4
1373,139752,2020-08-16,13,5,2241,81,4,Oberösterreich,18,86,5.8
1374,51827,2020-08-16,2,0,42,2,5,Salzburg,2,2,0.0
1375,89645,2020-08-16,5,3,1526,73,6,Steiermark,8,76,3.9
1376,175195,2020-08-16,6,0,4,28,7,Tirol,6,28,0.0
1377,51891,2020-08-16,1,0,83,23,8,Vorarlberg,1,23,0.0
1378,257960,2020-08-16,22,7,2308,323,9,Wien,29,330,2.1
1379,1018490,2020-08-16,65,19,8469,752,10,Alle,84,771,2.5
1380,25260,2020-08-17,0,0,346,12,1,Burgenland,0,12,0.0
1381,48043,2020-08-17,2,0,78,40,2,Kärnten,2,40,0.0
1382,180482,2020-08-17,22,4,2600,166,3,Niederösterreich,26,170,2.4
1383,140263,2020-08-17,16,5,2854,84,4,Oberösterreich,21,89,5.6
1384,52082,2020-08-17,4,0,40,2,5,Salzburg,4,2,0.0
1385,90327,2020-08-17,5,3,1578,89,6,Steiermark,8,92,3.3
1386,176111,2020-08-17,8,1,9,38,7,Tirol,9,39,2.6
1387,52273,2020-08-17,1,0,83,23,8,Vorarlberg,1,23,0.0
1388,259226,2020-08-17,33,10,2344,312,9,Wien,43,322,3.1
1389,1024067,2020-08-17,91,23,9932,766,10,Alle,114,789,2.9
1390,25621,2020-08-18,0,0,283,14,1,Burgenland,0,14,0.0
1391,48428,2020-08-18,2,0,78,40,2,Kärnten,2,40,0.0
1392,182207,2020-08-18,20,3,2557,167,3,Niederösterreich,23,170,1.8
1393,142632,2020-08-18,17,4,1366,84,4,Oberösterreich,21,88,4.5
1394,52399,2020-08-18,4,0,40,2,5,Salzburg,4,2,0.0
1395,93757,2020-08-18,5,3,1227,87,6,Steiermark,8,90,3.3
1396,177526,2020-08-18,8,1,9,33,7,Tirol,9,34,2.9
1397,52825,2020-08-18,2,0,82,30,8,Vorarlberg,2,30,0.0
1398,262493,2020-08-18,39,8,2170,329,9,Wien,47,337,2.4
1399,1037888,2020-08-18,97,19,7812,786,10,Alle,116,805,2.4
1400,26211,2020-08-19,0,0,290,11,1,Burgenland,0,11,0.0
1401,48932,2020-08-19,1,0,79,40,2,Kärnten,1,40,0.0
1402,183596,2020-08-19,16,5,1781,165,3,Niederösterreich,21,170,2.9
1403,144342,2020-08-19,18,4,2172,79,4,Oberösterreich,22,83,4.8
1404,53354,2020-08-19,4,0,98,4,5,Salzburg,4,4,0.0
1405,95789,2020-08-19,8,2,1058,72,6,Steiermark,10,74,2.7
1406,178622,2020-08-19,9,1,8,36,7,Tirol,10,37,2.7
1407,52962,2020-08-19,2,0,82,29,8,Vorarlberg,2,29,0.0
1408,265363,2020-08-19,43,8,2045,314,9,Wien,51,322,2.5
1409,1049171,2020-08-19,101,20,7613,750,10,Alle,121,770,2.6
1410,26688,2020-08-20,1,0,295,11,1,Burgenland,1,11,0.0
1411,49448,2020-08-20,1,1,79,39,2,Kärnten,2,40,2.5
1412,185069,2020-08-20,17,2,1605,168,3,Niederösterreich,19,170,1.2
1413,146606,2020-08-20,13,4,2102,73,4,Oberösterreich,17,77,5.2
1414,54143,2020-08-20,4,0,98,4,5,Salzburg,4,4,0.0
1415,97384,2020-08-20,6,2,1049,66,6,Steiermark,8,68,2.9
1416,179776,2020-08-20,9,2,8,35,7,Tirol,11,37,5.4
1417,53611,2020-08-20,2,0,82,23,8,Vorarlberg,2,23,0.0
1418,268712,2020-08-20,42,10,1951,310,9,Wien,52,320,3.1
1419,1061437,2020-08-20,95,21,7269,729,10,Alle,116,750,2.8
1420,27338,2020-08-21,1,0,317,10,1,Burgenland,1,10,0.0
1421,51507,2020-08-21,1,1,79,39,2,Kärnten,2,40,2.5
1422,186613,2020-08-21,14,2,1463,168,3,Niederösterreich,16,170,1.2
1423,148044,2020-08-21,15,4,2312,64,4,Oberösterreich,19,68,5.9
1424,54636,2020-08-21,5,1,97,3,5,Salzburg,6,4,25.0
1425,99761,2020-08-21,6,2,1057,86,6,Steiermark,8,88,2.3
1426,181229,2020-08-21,7,2,9,27,7,Tirol,9,29,6.9
1427,54690,2020-08-21,2,0,82,20,8,Vorarlberg,2,20,0.0
1428,271591,2020-08-21,39,10,1957,310,9,Wien,49,320,3.1
1429,1075409,2020-08-21,90,22,7373,727,10,Alle,112,749,2.9
1430,27975,2020-08-22,1,0,340,11,1,Burgenland,1,11,0.0
1431,52304,2020-08-22,1,1,79,39,2,Kärnten,2,40,2.5
1432,188189,2020-08-22,15,3,1554,167,3,Niederösterreich,18,170,1.8
1433,149396,2020-08-22,15,4,2312,64,4,Oberösterreich,19,68,5.9
1434,55088,2020-08-22,6,1,112,3,5,Salzburg,7,4,25.0
1435,101776,2020-08-22,6,1,1111,95,6,Steiermark,7,96,1.0
1436,182402,2020-08-22,7,2,9,27,7,Tirol,9,29,6.9
1437,55761,2020-08-22,2,0,82,21,8,Vorarlberg,2,21,0.0
1438,274264,2020-08-22,41,10,2159,307,9,Wien,51,317,3.2
1439,1087155,2020-08-22,94,22,7758,734,10,Alle,116,756,2.9
1440,28161,2020-08-23,1,0,376,14,1,Burgenland,1,14,0.0
1441,52505,2020-08-23,1,1,79,39,2,Kärnten,2,40,2.5
1442,189445,2020-08-23,13,3,1777,167,3,Niederösterreich,16,170,1.8
1443,150123,2020-08-23,15,4,2312,64,4,Oberösterreich,19,68,5.9
1444,55391,2020-08-23,5,1,113,3,5,Salzburg,6,4,25.0
1445,103091,2020-08-23,4,1,1527,86,6,Steiermark,5,87,1.1
1446,183554,2020-08-23,7,2,9,27,7,Tirol,9,29,6.9
1447,57078,2020-08-23,2,0,82,21,8,Vorarlberg,2,21,0.0
1448,275639,2020-08-23,45,11,2283,307,9,Wien,56,318,3.5
1449,1094987,2020-08-23,93,23,8558,728,10,Alle,116,751,3.1
1450,28246,2020-08-24,1,0,803,16,1,Burgenland,1,16,0.0
1451,52598,2020-08-24,2,1,79,39,2,Kärnten,3,40,2.5
1452,190724,2020-08-24,15,2,2506,168,3,Niederösterreich,17,170,1.2
1453,150779,2020-08-24,15,6,2804,80,4,Oberösterreich,21,86,7.0
1454,55573,2020-08-24,5,1,113,3,5,Salzburg,6,4,25.0
1455,103978,2020-08-24,4,1,1587,87,6,Steiermark,5,88,1.1
1456,184445,2020-08-24,11,2,5,36,7,Tirol,13,38,5.3
1457,57350,2020-08-24,2,0,82,21,8,Vorarlberg,2,21,0.0
1458,277513,2020-08-24,57,10,2486,329,9,Wien,67,339,2.9
1459,1101206,2020-08-24,112,23,10465,779,10,Alle,135,802,2.9
1460,28436,2020-08-25,1,0,311,16,1,Burgenland,1,16,0.0
1461,52915,2020-08-25,3,0,77,40,2,Kärnten,3,40,0.0
1462,192181,2020-08-25,15,3,2516,167,3,Niederösterreich,18,170,1.8
1463,151613,2020-08-25,17,4,2331,73,4,Oberösterreich,21,77,5.2
1464,55981,2020-08-25,5,1,113,3,5,Salzburg,6,4,25.0
1465,105070,2020-08-25,4,1,1187,88,6,Steiermark,5,89,1.1
1466,185521,2020-08-25,8,3,8,31,7,Tirol,11,34,8.8
1467,57690,2020-08-25,1,0,83,26,8,Vorarlberg,1,26,0.0
1468,280682,2020-08-25,60,11,2305,313,9,Wien,71,324,3.4
1469,1110089,2020-08-25,114,23,8931,757,10,Alle,137,780,2.9
1470,28633,2020-08-26,0,0,293,17,1,Burgenland,0,17,0.0
1471,52915,2020-08-26,3,0,77,40,2,Kärnten,3,40,0.0
1472,193829,2020-08-26,13,4,1772,166,3,Niederösterreich,17,170,2.4
1473,152788,2020-08-26,19,4,2111,77,4,Oberösterreich,23,81,4.9
1474,56168,2020-08-26,5,1,113,3,5,Salzburg,6,4,25.0
1475,106458,2020-08-26,8,0,1071,93,6,Steiermark,8,93,0.0
1476,186620,2020-08-26,7,3,9,31,7,Tirol,10,34,8.8
1477,58229,2020-08-26,2,0,82,24,8,Vorarlberg,2,24,0.0
1478,283559,2020-08-26,61,11,2106,301,9,Wien,72,312,3.5
1479,1119199,2020-08-26,118,23,7634,752,10,Alle,141,775,3.0
1480,29194,2020-08-27,0,1,316,19,1,Burgenland,1,20,5.0
1481,53515,2020-08-27,3,0,76,40,2,Kärnten,3,40,0.0
1482,195539,2020-08-27,17,5,1563,165,3,Niederösterreich,22,170,2.9
1483,154389,2020-08-27,20,4,2058,76,4,Oberösterreich,24,80,5.0
1484,56731,2020-08-27,6,1,112,3,5,Salzburg,7,4,25.0
1485,108816,2020-08-27,8,0,979,93,6,Steiermark,8,93,0.0
1486,187731,2020-08-27,8,2,9,27,7,Tirol,10,29,6.9
1487,58809,2020-08-27,2,0,82,28,8,Vorarlberg,2,28,0.0
1488,288519,2020-08-27,57,11,2058,279,9,Wien,68,290,3.8
1489,1133243,2020-08-27,121,24,7253,730,10,Alle,145,754,3.2
1490,29391,2020-08-28,0,1,311,14,1,Burgenland,1,15,6.7
1491,55676,2020-08-28,2,0,78,40,2,Kärnten,2,40,0.0
1492,197676,2020-08-28,15,8,1420,162,3,Niederösterreich,23,170,4.7
1493,155704,2020-08-28,20,4,2182,80,4,Oberösterreich,24,84,4.8
1494,57008,2020-08-28,6,1,112,3,5,Salzburg,7,4,25.0
1495,110217,2020-08-28,6,0,887,102,6,Steiermark,6,102,0.0
1496,188688,2020-08-28,8,2,7,24,7,Tirol,10,26,7.7
1497,59467,2020-08-28,2,0,82,22,8,Vorarlberg,2,22,0.0
1498,294117,2020-08-28,60,11,2044,281,9,Wien,71,292,3.8
1499,1147944,2020-08-28,119,27,7123,728,10,Alle,146,755,3.6
1500,29625,2020-08-29,0,1,374,12,1,Burgenland,1,13,7.7
1501,55939,2020-08-29,2,0,78,40,2,Kärnten,2,40,0.0
1502,199311,2020-08-29,13,10,1376,160,3,Niederösterreich,23,170,5.9
1503,156779,2020-08-29,20,4,2182,80,4,Oberösterreich,24,84,4.8
1504,57313,2020-08-29,5,1,113,3,5,Salzburg,6,4,25.0
1505,111274,2020-08-29,6,0,887,102,6,Steiermark,6,102,0.0
1506,190091,2020-08-29,8,2,7,24,7,Tirol,10,26,7.7
1507,61048,2020-08-29,3,0,81,20,8,Vorarlberg,3,20,0.0
1508,299363,2020-08-29,57,12,2226,295,9,Wien,69,307,3.9
1509,1160743,2020-08-29,114,30,7324,736,10,Alle,144,766,3.9
1510,29786,2020-08-30,0,1,395,11,1,Burgenland,1,12,8.3
1511,56081,2020-08-30,2,0,78,40,2,Kärnten,2,40,0.0
1512,200882,2020-08-30,13,10,1549,160,3,Niederösterreich,23,170,5.9
1513,159206,2020-08-30,20,4,2182,80,4,Oberösterreich,24,84,4.8
1514,57732,2020-08-30,7,0,111,4,5,Salzburg,7,4,0.0
1515,111765,2020-08-30,6,0,1471,108,6,Steiermark,6,108,0.0
1516,190909,2020-08-30,8,2,7,24,7,Tirol,10,26,7.7
1517,61671,2020-08-30,3,0,81,20,8,Vorarlberg,3,20,0.0
1518,304060,2020-08-30,51,13,2302,294,9,Wien,64,307,4.2
1519,1172092,2020-08-30,110,30,8176,741,10,Alle,140,771,3.9
1520,29861,2020-08-31,0,1,355,10,1,Burgenland,1,11,9.1
1521,56152,2020-08-31,1,2,79,38,2,Kärnten,3,40,5.0
1522,202393,2020-08-31,14,10,2384,160,3,Niederösterreich,24,170,5.9
1523,159914,2020-08-31,20,3,2833,81,4,Oberösterreich,23,84,3.6
1524,57884,2020-08-31,7,0,111,4,5,Salzburg,7,4,0.0
1525,112433,2020-08-31,5,0,1463,106,6,Steiermark,5,106,0.0
1526,191779,2020-08-31,7,2,5,30,7,Tirol,9,32,6.2
1527,62050,2020-08-31,3,0,81,20,8,Vorarlberg,3,20,0.0
1528,308245,2020-08-31,66,13,2446,292,9,Wien,79,305,4.3
1529,1180711,2020-08-31,123,31,9757,741,10,Alle,154,772,4.0
1530,30639,2020-09-01,0,1,402,10,1,Burgenland,1,11,9.1
1531,56537,2020-09-01,1,2,79,38,2,Kärnten,3,40,5.0
1532,204453,2020-09-01,15,9,2409,161,3,Niederösterreich,24,170,5.3
1533,160821,2020-09-01,18,4,2330,72,4,Oberösterreich,22,76,5.3
1534,58326,2020-09-01,7,0,111,4,5,Salzburg,7,4,0.0
1535,114069,2020-09-01,7,0,1081,106,6,Steiermark,7,106,0.0
1536,192764,2020-09-01,7,0,2,23,7,Tirol,7,23,0.0
1537,62645,2020-09-01,4,0,80,22,8,Vorarlberg,4,22,0.0
1538,312873,2020-09-01,60,14,2555,299,9,Wien,74,313,4.5
1539,1193127,2020-09-01,119,30,9049,735,10,Alle,149,765,3.9
1540,33297,2020-09-02,0,1,361,11,1,Burgenland,1,12,8.3
1541,60984,2020-09-02,2,1,78,39,2,Kärnten,3,40,2.5
1542,206661,2020-09-02,14,8,1759,162,3,Niederösterreich,22,170,4.7
1543,162015,2020-09-02,18,3,2188,71,4,Oberösterreich,21,74,4.1
1544,58440,2020-09-02,7,0,111,4,5,Salzburg,7,4,0.0
1545,115205,2020-09-02,7,0,1068,104,6,Steiermark,7,104,0.0
1546,193666,2020-09-02,7,0,3,28,7,Tirol,7,28,0.0
1547,63006,2020-09-02,4,1,80,22,8,Vorarlberg,5,23,4.3
1548,317294,2020-09-02,68,16,2347,287,9,Wien,84,303,5.3
1549,1210568,2020-09-02,127,30,7995,728,10,Alle,157,758,4.0
1550,34034,2020-09-03,0,1,329,10,1,Burgenland,1,11,9.1
1551,61242,2020-09-03,2,1,78,39,2,Kärnten,3,40,2.5
1552,208128,2020-09-03,12,7,1637,163,3,Niederösterreich,19,170,4.1
1553,163161,2020-09-03,22,3,2093,83,4,Oberösterreich,25,86,3.5
1554,59119,2020-09-03,7,0,111,4,5,Salzburg,7,4,0.0
1555,116635,2020-09-03,8,0,1155,92,6,Steiermark,8,92,0.0
1556,194970,2020-09-03,7,0,5,24,7,Tirol,7,24,0.0
1557,63739,2020-09-03,2,1,82,17,8,Vorarlberg,3,18,5.6
1558,321229,2020-09-03,72,16,2347,287,9,Wien,88,303,5.3
1559,1222257,2020-09-03,132,29,7837,719,10,Alle,161,748,3.9
1560,34892,2020-09-04,0,0,338,10,1,Burgenland,0,10,0.0
1561,63277,2020-09-04,2,1,78,39,2,Kärnten,3,40,2.5
1562,210189,2020-09-04,12,5,1478,165,3,Niederösterreich,17,170,2.9
1563,164126,2020-09-04,20,3,2110,69,4,Oberösterreich,23,72,4.2
1564,59296,2020-09-04,7,0,111,4,5,Salzburg,7,4,0.0
1565,118165,2020-09-04,9,0,1082,88,6,Steiermark,9,88,0.0
1566,196412,2020-09-04,7,0,1,24,7,Tirol,7,24,0.0
1567,64677,2020-09-04,2,1,82,14,8,Vorarlberg,3,15,6.7
1568,325455,2020-09-04,69,18,2213,245,9,Wien,87,263,6.8
1569,1236489,2020-09-04,128,28,7493,658,10,Alle,156,686,4.1
1570,35399,2020-09-05,0,0,400,10,1,Burgenland,0,10,0.0
1571,63468,2020-09-05,1,1,79,39,2,Kärnten,2,40,2.5
1572,212444,2020-09-05,10,5,1501,165,3,Niederösterreich,15,170,2.9
1573,165173,2020-09-05,20,3,2110,69,4,Oberösterreich,23,72,4.2
1574,59559,2020-09-05,7,0,111,4,5,Salzburg,7,4,0.0
1575,119253,2020-09-05,10,0,1140,95,6,Steiermark,10,95,0.0
1576,197737,2020-09-05,7,0,1,24,7,Tirol,7,24,0.0
1577,65537,2020-09-05,2,1,82,16,8,Vorarlberg,3,17,5.9
1578,329237,2020-09-05,72,18,2387,269,9,Wien,90,287,6.3
1579,1247807,2020-09-05,129,28,7811,691,10,Alle,157,719,3.9
1580,35715,2020-09-06,0,0,391,13,1,Burgenland,0,13,0.0
1581,63550,2020-09-06,1,1,79,39,2,Kärnten,2,40,2.5
1582,214267,2020-09-06,8,5,1672,165,3,Niederösterreich,13,170,2.9
1583,165818,2020-09-06,20,3,2110,69,4,Oberösterreich,23,72,4.2
1584,59810,2020-09-06,2,0,116,4,5,Salzburg,2,4,0.0
1585,119549,2020-09-06,10,0,1512,101,6,Steiermark,10,101,0.0
1586,198472,2020-09-06,7,0,1,24,7,Tirol,7,24,0.0
1587,66892,2020-09-06,2,1,82,16,8,Vorarlberg,3,17,5.9
1588,331752,2020-09-06,65,18,2482,264,9,Wien,83,282,6.4
1589,1255825,2020-09-06,115,28,8445,695,10,Alle,143,723,3.9
1590,35857,2020-09-07,0,0,363,13,1,Burgenland,0,13,0.0
1591,63604,2020-09-07,1,1,79,39,2,Kärnten,2,40,2.5
1592,215919,2020-09-07,9,5,2533,165,3,Niederösterreich,14,170,2.9
1593,170371,2020-09-07,28,3,2799,88,4,Oberösterreich,31,91,3.3
1594,59964,2020-09-07,2,0,116,4,5,Salzburg,2,4,0.0
1595,120178,2020-09-07,8,1,1591,92,6,Steiermark,9,93,1.1
1596,199037,2020-09-07,14,0,2,41,7,Tirol,14,41,0.0
1597,67146,2020-09-07,2,1,82,16,8,Vorarlberg,3,17,5.9
1598,334147,2020-09-07,70,18,2650,231,9,Wien,88,249,7.2
1599,1266223,2020-09-07,134,29,10215,689,10,Alle,163,718,4.0
1600,36085,2020-09-08,0,0,304,16,1,Burgenland,0,16,0.0
1601,64205,2020-09-08,1,0,79,40,2,Kärnten,1,40,0.0
1602,217933,2020-09-08,12,5,2542,165,3,Niederösterreich,17,170,2.9
1603,171517,2020-09-08,23,4,2244,68,4,Oberösterreich,27,72,5.6
1604,60336,2020-09-08,3,0,115,4,5,Salzburg,3,4,0.0
1605,121440,2020-09-08,8,1,1206,79,6,Steiermark,9,80,1.2
1606,200020,2020-09-08,11,0,5,46,7,Tirol,11,46,0.0
1607,67375,2020-09-08,1,1,83,16,8,Vorarlberg,2,17,5.9
1608,337566,2020-09-08,83,17,2519,265,9,Wien,100,282,6.0
1609,1276477,2020-09-08,142,28,9097,699,10,Alle,170,727,3.9
1610,36314,2020-09-09,3,0,287,16,1,Burgenland,3,16,0.0
1611,64523,2020-09-09,0,1,80,39,2,Kärnten,1,40,2.5
1612,219532,2020-09-09,12,7,1835,163,3,Niederösterreich,19,170,4.1
1613,172863,2020-09-09,19,4,2144,63,4,Oberösterreich,23,67,6.0
1614,60612,2020-09-09,4,0,114,4,5,Salzburg,4,4,0.0
1615,123225,2020-09-09,7,1,1177,76,6,Steiermark,8,77,1.3
1616,201209,2020-09-09,12,1,5,41,7,Tirol,13,42,2.4
1617,67858,2020-09-09,7,1,77,14,8,Vorarlberg,8,15,6.7
1618,341923,2020-09-09,97,21,2190,268,9,Wien,118,289,7.3
1619,1288059,2020-09-09,161,36,7909,684,10,Alle,197,720,5.0
1620,37283,2020-09-10,1,0,284,13,1,Burgenland,1,13,0.0
1621,64833,2020-09-10,1,1,79,39,2,Kärnten,2,40,2.5
1622,222233,2020-09-10,8,8,1608,162,3,Niederösterreich,16,170,4.7
1623,174053,2020-09-10,19,3,2020,58,4,Oberösterreich,22,61,4.9
1624,61152,2020-09-10,6,0,96,4,5,Salzburg,6,4,0.0
1625,124575,2020-09-10,8,3,1063,75,6,Steiermark,11,78,3.8
1626,202371,2020-09-10,12,1,5,38,7,Tirol,13,39,2.6
1627,68695,2020-09-10,4,1,80,11,8,Vorarlberg,5,12,8.3
1628,347835,2020-09-10,107,22,2002,271,9,Wien,129,293,7.5
1629,1303030,2020-09-10,166,39,7237,671,10,Alle,205,710,5.5
1630,37632,2020-09-11,1,0,297,13,1,Burgenland,1,13,0.0
1631,66365,2020-09-11,2,1,78,39,2,Kärnten,3,40,2.5
1632,224473,2020-09-11,9,8,1408,162,3,Niederösterreich,17,170,4.7
1633,175081,2020-09-11,16,2,2111,62,4,Oberösterreich,18,64,3.1
1634,61531,2020-09-11,6,0,96,4,5,Salzburg,6,4,0.0
1635,125933,2020-09-11,8,3,1071,74,6,Steiermark,11,77,3.9
1636,203760,2020-09-11,9,1,7,39,7,Tirol,10,40,2.5
1637,69661,2020-09-11,5,2,77,13,8,Vorarlberg,7,15,13.3
1638,352383,2020-09-11,107,24,2068,262,9,Wien,131,286,8.4
1639,1316819,2020-09-11,163,41,7213,668,10,Alle,204,709,5.8
1640,38382,2020-09-12,2,0,351,13,1,Burgenland,2,13,0.0
1641,66573,2020-09-12,2,1,78,39,2,Kärnten,3,40,2.5
1642,226050,2020-09-12,10,8,1467,162,3,Niederösterreich,18,170,4.7
1643,176037,2020-09-12,16,2,2111,62,4,Oberösterreich,18,64,3.1
1644,61825,2020-09-12,7,1,95,3,5,Salzburg,8,4,25.0
1645,127311,2020-09-12,11,3,1155,74,6,Steiermark,14,77,3.9
1646,205200,2020-09-12,9,1,7,39,7,Tirol,10,40,2.5
1647,70929,2020-09-12,6,2,76,12,8,Vorarlberg,8,14,14.3
1648,359186,2020-09-12,104,24,2268,271,9,Wien,128,295,8.1
1649,1331493,2020-09-12,167,42,7608,675,10,Alle,209,717,5.9
1650,38506,2020-09-13,5,2,418,15,1,Burgenland,7,17,11.8
1651,66712,2020-09-13,3,0,77,40,2,Kärnten,3,40,0.0
1652,227948,2020-09-13,11,9,1691,161,3,Niederösterreich,20,170,5.3
1653,176734,2020-09-13,16,2,2111,62,4,Oberösterreich,18,64,3.1
1654,62066,2020-09-13,4,1,98,3,5,Salzburg,5,4,25.0
1655,128006,2020-09-13,15,3,1531,79,6,Steiermark,18,82,3.7
1656,206161,2020-09-13,9,1,7,39,7,Tirol,10,40,2.5
1657,72314,2020-09-13,6,2,76,12,8,Vorarlberg,8,14,14.3
1658,363619,2020-09-13,113,24,2424,267,9,Wien,137,291,8.2
1659,1342066,2020-09-13,182,44,8433,678,10,Alle,226,722,6.1
1660,38634,2020-09-14,4,2,371,16,1,Burgenland,6,18,11.1
1661,66838,2020-09-14,2,1,78,39,2,Kärnten,3,40,2.5
1662,230082,2020-09-14,17,7,2492,163,3,Niederösterreich,24,170,4.1
1663,179258,2020-09-14,28,2,2837,71,4,Oberösterreich,30,73,2.7
1664,62211,2020-09-14,4,1,98,3,5,Salzburg,5,4,25.0
1665,128376,2020-09-14,15,3,1583,88,6,Steiermark,18,91,3.3
1666,207020,2020-09-14,14,1,2,48,7,Tirol,15,49,2.0
1667,72393,2020-09-14,6,2,76,12,8,Vorarlberg,8,14,14.3
1668,366596,2020-09-14,118,28,2467,290,9,Wien,146,318,8.8
1669,1351408,2020-09-14,208,47,10004,730,10,Alle,255,777,6.0
1670,39455,2020-09-15,5,1,330,15,1,Burgenland,6,16,6.2
1671,67492,2020-09-15,5,1,75,39,2,Kärnten,6,40,2.5
1672,231710,2020-09-15,25,7,2448,163,3,Niederösterreich,32,170,4.1
1673,180300,2020-09-15,27,2,2170,67,4,Oberösterreich,29,69,2.9
1674,62410,2020-09-15,5,1,97,3,5,Salzburg,6,4,25.0
1675,130356,2020-09-15,23,3,1150,94,6,Steiermark,26,97,3.1
1676,208394,2020-09-15,12,1,4,35,7,Tirol,13,36,2.8
1677,73060,2020-09-15,11,3,70,22,8,Vorarlberg,14,25,12.0
1678,371331,2020-09-15,131,30,2287,289,9,Wien,161,319,9.4
1679,1364508,2020-09-15,244,49,8631,727,10,Alle,293,776,6.3
1680,40037,2020-09-16,6,1,287,12,1,Burgenland,7,13,7.7
1681,67986,2020-09-16,6,1,74,39,2,Kärnten,7,40,2.5
1682,234165,2020-09-16,22,9,1592,161,3,Niederösterreich,31,170,5.3
1683,181938,2020-09-16,33,2,2049,71,4,Oberösterreich,35,73,2.7
1684,62910,2020-09-16,7,1,95,3,5,Salzburg,8,4,25.0
1685,131934,2020-09-16,22,4,990,90,6,Steiermark,26,94,4.3
1686,209956,2020-09-16,14,2,2,33,7,Tirol,16,35,5.7
1687,73911,2020-09-16,12,3,69,12,8,Vorarlberg,15,15,20.0
1688,377002,2020-09-16,145,31,2058,233,9,Wien,176,264,11.7
1689,1379839,2020-09-16,267,54,7216,654,10,Alle,321,708,7.6
1690,40600,2020-09-17,6,1,254,12,1,Burgenland,7,13,7.7
1691,68401,2020-09-17,6,1,74,39,2,Kärnten,7,40,2.5
1692,236324,2020-09-17,25,8,1397,162,3,Niederösterreich,33,170,4.7
1693,183608,2020-09-17,29,2,1968,68,4,Oberösterreich,31,70,2.9
1694,63402,2020-09-17,9,1,93,3,5,Salzburg,10,4,25.0
1695,133609,2020-09-17,24,5,990,90,6,Steiermark,29,95,5.3
1696,211061,2020-09-17,13,2,4,65,7,Tirol,15,67,3.0
1697,74680,2020-09-17,14,3,70,16,8,Vorarlberg,17,19,15.8
1698,383426,2020-09-17,138,32,1985,257,9,Wien,170,289,11.1
1699,1395111,2020-09-17,264,55,6835,712,10,Alle,319,767,7.2
1700,41639,2020-09-18,4,3,261,17,1,Burgenland,7,20,15.0
1701,70795,2020-09-18,6,1,74,39,2,Kärnten,7,40,2.5
1702,237215,2020-09-18,27,9,1266,161,3,Niederösterreich,36,170,5.3
1703,185251,2020-09-18,33,2,2029,75,4,Oberösterreich,35,77,2.6
1704,63867,2020-09-18,10,2,92,3,5,Salzburg,12,5,40.0
1705,135566,2020-09-18,26,5,894,92,6,Steiermark,31,97,5.2
1706,213271,2020-09-18,15,3,2,40,7,Tirol,18,43,7.0
1707,76006,2020-09-18,14,3,70,16,8,Vorarlberg,17,19,15.8
1708,390355,2020-09-18,137,34,2034,271,9,Wien,171,305,11.1
1709,1413965,2020-09-18,272,62,6722,714,10,Alle,334,776,8.0
1710,42217,2020-09-19,5,3,341,12,1,Burgenland,8,15,20.0
1711,71131,2020-09-19,7,1,73,39,2,Kärnten,8,40,2.5
1712,239740,2020-09-19,26,12,1345,158,3,Niederösterreich,38,170,7.1
1713,186664,2020-09-19,33,2,2029,75,4,Oberösterreich,35,77,2.6
1714,64639,2020-09-19,8,2,94,3,5,Salzburg,10,5,40.0
1715,137321,2020-09-19,30,5,1045,92,6,Steiermark,35,97,5.2
1716,215852,2020-09-19,15,3,2,40,7,Tirol,18,43,7.0
1717,77017,2020-09-19,14,3,70,15,8,Vorarlberg,17,18,16.7
1718,397518,2020-09-19,127,53,2272,263,9,Wien,180,316,16.8
1719,1432099,2020-09-19,265,84,7271,697,10,Alle,349,781,10.8
1720,42354,2020-09-20,6,2,380,12,1,Burgenland,8,14,14.3
1721,71293,2020-09-20,7,1,73,39,2,Kärnten,8,40,2.5
1722,241892,2020-09-20,28,12,1622,158,3,Niederösterreich,40,170,7.1
1723,187781,2020-09-20,33,2,2029,75,4,Oberösterreich,35,77,2.6
1724,65051,2020-09-20,8,2,94,3,5,Salzburg,10,5,40.0
1725,137802,2020-09-20,27,5,1419,97,6,Steiermark,32,102,4.9
1726,217533,2020-09-20,15,3,2,40,7,Tirol,18,43,7.0
1727,78516,2020-09-20,14,3,70,15,8,Vorarlberg,17,18,16.7
1728,402461,2020-09-20,135,38,2316,271,9,Wien,173,309,12.3
1729,1444683,2020-09-20,273,68,8005,710,10,Alle,341,778,8.7
1730,42545,2020-09-21,8,1,332,14,1,Burgenland,9,15,6.7
1731,71485,2020-09-21,9,3,71,37,2,Kärnten,12,40,7.5
1732,243444,2020-09-21,31,11,2500,159,3,Niederösterreich,42,170,6.5
1733,190527,2020-09-21,38,2,2647,78,4,Oberösterreich,40,80,2.5
1734,65436,2020-09-21,8,2,94,3,5,Salzburg,10,5,40.0
1735,139485,2020-09-21,30,5,1480,104,6,Steiermark,35,109,4.6
1736,218557,2020-09-21,17,2,0,41,7,Tirol,19,43,4.7
1737,79786,2020-09-21,14,3,70,15,8,Vorarlberg,17,18,16.7
1738,406830,2020-09-21,142,38,2242,263,9,Wien,180,301,12.6
1739,1458095,2020-09-21,297,67,9436,714,10,Alle,364,781,8.6
1740,42848,2020-09-22,6,1,293,13,1,Burgenland,7,14,7.1
1741,72083,2020-09-22,11,3,69,37,2,Kärnten,14,40,7.5
1742,245789,2020-09-22,45,15,2508,155,3,Niederösterreich,60,170,8.8
1743,191938,2020-09-22,40,4,2099,78,4,Oberösterreich,44,82,4.9
1744,65943,2020-09-22,7,2,95,3,5,Salzburg,9,5,40.0
1745,141821,2020-09-22,31,5,1130,95,6,Steiermark,36,100,5.0
1746,219840,2020-09-22,15,3,2,33,7,Tirol,18,36,8.3
1747,80633,2020-09-22,12,3,69,20,8,Vorarlberg,15,23,13.0
1748,411752,2020-09-22,148,39,2141,235,9,Wien,187,274,14.2
1749,1472647,2020-09-22,315,75,8406,669,10,Alle,390,744,10.1
1750,43847,2020-09-23,4,0,278,13,1,Burgenland,4,13,0.0
1751,72950,2020-09-23,11,3,69,37,2,Kärnten,14,40,7.5
1752,248929,2020-09-23,54,15,1720,155,3,Niederösterreich,69,170,8.8
1753,193891,2020-09-23,35,5,1931,71,4,Oberösterreich,40,76,6.6
1754,66546,2020-09-23,9,1,93,4,5,Salzburg,10,5,20.0
1755,143167,2020-09-23,38,4,963,89,6,Steiermark,42,93,4.3
1756,221878,2020-09-23,25,4,5,23,7,Tirol,29,27,14.8
1757,81252,2020-09-23,9,3,72,16,8,Vorarlberg,12,19,15.8
1758,416804,2020-09-23,151,42,2122,219,9,Wien,193,261,16.1
1759,1489264,2020-09-23,336,77,7253,627,10,Alle,413,704,10.9
1760,44375,2020-09-24,7,0,290,16,1,Burgenland,7,16,0.0
1761,73604,2020-09-24,13,2,67,38,2,Kärnten,15,40,5.0
1762,252024,2020-09-24,56,13,1538,157,3,Niederösterreich,69,170,7.6
1763,196032,2020-09-24,36,5,1929,67,4,Oberösterreich,41,72,6.9
1764,67453,2020-09-24,11,1,91,4,5,Salzburg,12,5,20.0
1765,144870,2020-09-24,38,8,939,93,6,Steiermark,46,101,7.9
1766,223494,2020-09-24,20,5,32,21,7,Tirol,25,26,19.2
1767,82110,2020-09-24,9,3,72,16,8,Vorarlberg,12,19,15.8
1768,423820,2020-09-24,154,41,1791,229,9,Wien,195,270,15.2
1769,1507782,2020-09-24,344,78,6749,641,10,Alle,422,719,10.8
1770,45283,2020-09-25,3,0,283,13,1,Burgenland,3,13,0.0
1771,76048,2020-09-25,9,1,71,39,2,Kärnten,10,40,2.5
1772,255064,2020-09-25,56,15,1381,155,3,Niederösterreich,71,170,8.8
1773,198596,2020-09-25,35,5,1880,60,4,Oberösterreich,40,65,7.7
1774,68262,2020-09-25,10,1,92,4,5,Salzburg,11,5,20.0
1775,146870,2020-09-25,38,7,948,91,6,Steiermark,45,98,7.1
1776,225403,2020-09-25,20,5,31,31,7,Tirol,25,36,13.9
1777,83161,2020-09-25,6,4,74,15,8,Vorarlberg,10,19,21.1
1778,429504,2020-09-25,156,40,1494,248,9,Wien,196,288,13.9
1779,1528191,2020-09-25,333,78,6254,656,10,Alle,411,734,10.6
1780,45875,2020-09-26,6,1,360,12,1,Burgenland,7,13,7.7
1781,76550,2020-09-26,10,1,70,39,2,Kärnten,11,40,2.5
1782,258344,2020-09-26,61,13,1478,157,3,Niederösterreich,74,170,7.6
1783,200542,2020-09-26,35,5,1880,60,4,Oberösterreich,40,65,7.7
1784,68479,2020-09-26,12,1,90,4,5,Salzburg,13,5,20.0
1785,149333,2020-09-26,39,6,897,91,6,Steiermark,45,97,6.2
1786,227296,2020-09-26,20,5,31,31,7,Tirol,25,36,13.9
1787,84223,2020-09-26,3,5,76,7,8,Vorarlberg,8,12,41.7
1788,434992,2020-09-26,157,43,2155,252,9,Wien,200,295,14.6
1789,1545634,2020-09-26,343,80,7037,653,10,Alle,423,733,10.9
1790,46351,2020-09-27,7,1,404,15,1,Burgenland,8,16,6.2
1791,76778,2020-09-27,12,2,68,38,2,Kärnten,14,40,5.0
1792,260035,2020-09-27,66,13,1710,157,3,Niederösterreich,79,170,7.6
1793,201656,2020-09-27,35,5,1880,60,4,Oberösterreich,40,65,7.7
1794,68580,2020-09-27,8,1,94,4,5,Salzburg,9,5,20.0
1795,149993,2020-09-27,40,8,1331,104,6,Steiermark,48,112,7.1
1796,228548,2020-09-27,20,5,31,31,7,Tirol,25,36,13.9
1797,86095,2020-09-27,3,5,76,7,8,Vorarlberg,8,12,41.7
1798,437463,2020-09-27,171,44,2206,240,9,Wien,215,284,15.5
1799,1555499,2020-09-27,362,84,7800,656,10,Alle,446,740,11.4
1800,46505,2020-09-28,6,2,363,15,1,Burgenland,8,17,11.8
1801,76968,2020-09-28,10,1,70,39,2,Kärnten,11,40,2.5
1802,263105,2020-09-28,74,13,2591,157,3,Niederösterreich,87,170,7.6
1803,204685,2020-09-28,39,5,2646,69,4,Oberösterreich,44,74,6.8
1804,69193,2020-09-28,7,2,95,2,5,Salzburg,9,4,50.0
1805,151875,2020-09-28,40,8,1420,95,6,Steiermark,48,103,7.8
1806,229398,2020-09-28,25,4,13,44,7,Tirol,29,48,8.3
1807,87118,2020-09-28,3,5,76,7,8,Vorarlberg,8,12,41.7
1808,441145,2020-09-28,177,48,2214,247,9,Wien,225,295,16.3
1809,1569992,2020-09-28,381,88,9488,675,10,Alle,469,763,11.5
1810,47338,2020-09-29,6,3,325,16,1,Burgenland,9,19,15.8
1811,78010,2020-09-29,10,1,70,39,2,Kärnten,11,40,2.5
1812,265717,2020-09-29,80,13,2593,157,3,Niederösterreich,93,170,7.6
1813,206403,2020-09-29,45,6,2053,57,4,Oberösterreich,51,63,9.5
1814,69696,2020-09-29,8,2,94,2,5,Salzburg,10,4,50.0
1815,153499,2020-09-29,40,9,909,88,6,Steiermark,49,97,9.3
1816,229719,2020-09-29,22,4,15,37,7,Tirol,26,41,9.8
1817,88155,2020-09-29,5,3,76,14,8,Vorarlberg,8,17,17.6
1818,448041,2020-09-29,185,49,2219,238,9,Wien,234,287,17.1
1819,1586578,2020-09-29,401,90,8354,648,10,Alle,491,738,12.2
1820,47996,2020-09-30,6,3,298,16,1,Burgenland,9,19,15.8
1821,78719,2020-09-30,8,2,72,38,2,Kärnten,10,40,5.0
1822,267881,2020-09-30,77,13,1815,157,3,Niederösterreich,90,170,7.6
1823,208280,2020-09-30,44,5,1930,57,4,Oberösterreich,49,62,8.1
1824,84422,2020-09-30,11,1,91,3,5,Salzburg,12,4,25.0
1825,154854,2020-09-30,42,7,872,85,6,Steiermark,49,92,7.6
1826,231619,2020-09-30,19,4,16,37,7,Tirol,23,41,9.8
1827,89928,2020-09-30,7,3,77,12,8,Vorarlberg,10,15,20.0
1828,454288,2020-09-30,192,52,2050,235,9,Wien,244,287,18.1
1829,1617987,2020-09-30,406,90,7221,640,10,Alle,496,730,12.3
1830,49020,2020-10-01,8,4,286,15,1,Burgenland,12,19,21.1
1831,79599,2020-10-01,7,2,73,38,2,Kärnten,9,40,5.0
1832,269904,2020-10-01,75,12,1653,158,3,Niederösterreich,87,170,7.1
1833,210372,2020-10-01,42,5,1949,48,4,Oberösterreich,47,53,9.4
1834,85056,2020-10-01,13,1,89,3,5,Salzburg,14,4,25.0
1835,157184,2020-10-01,41,11,924,92,6,Steiermark,52,103,10.7
1836,233645,2020-10-01,17,5,18,33,7,Tirol,22,38,13.2
1837,90938,2020-10-01,6,4,74,11,8,Vorarlberg,10,15,26.7
1838,460855,2020-10-01,186,54,1995,252,9,Wien,240,306,17.6
1839,1636573,2020-10-01,395,98,7061,650,10,Alle,493,748,13.1
1840,49410,2020-10-02,11,4,300,18,1,Burgenland,15,22,18.2
1841,82267,2020-10-02,5,2,75,38,2,Kärnten,7,40,5.0
1842,273276,2020-10-02,70,15,1468,155,3,Niederösterreich,85,170,8.8
1843,212111,2020-10-02,42,4,1924,49,4,Oberösterreich,46,53,7.5
1844,86895,2020-10-02,11,1,91,3,5,Salzburg,12,4,25.0
1845,159638,2020-10-02,41,10,747,89,6,Steiermark,51,99,10.1
1846,235258,2020-10-02,17,5,18,33,7,Tirol,22,38,13.2
1847,92357,2020-10-02,8,4,72,8,8,Vorarlberg,12,12,33.3
1848,467200,2020-10-02,167,55,1966,237,9,Wien,222,292,18.8
1849,1658412,2020-10-02,372,100,6661,630,10,Alle,472,730,13.7
1850,49714,2020-10-03,13,2,360,14,1,Burgenland,15,16,12.5
1851,82810,2020-10-03,7,1,73,39,2,Kärnten,8,40,2.5
1852,275412,2020-10-03,70,15,1561,155,3,Niederösterreich,85,170,8.8
1853,213843,2020-10-03,42,4,1924,49,4,Oberösterreich,46,53,7.5
1854,87512,2020-10-03,11,1,91,3,5,Salzburg,12,4,25.0
1855,161913,2020-10-03,42,10,891,90,6,Steiermark,52,100,10.0
1856,237118,2020-10-03,24,5,60,65,7,Tirol,29,70,7.1
1857,93387,2020-10-03,18,5,66,12,8,Vorarlberg,23,17,29.4
1858,472159,2020-10-03,170,54,2158,246,9,Wien,224,300,18.0
1859,1673868,2020-10-03,397,97,7184,673,10,Alle,494,770,12.6
1860,50109,2020-10-04,11,4,361,14,1,Burgenland,15,18,22.2
1861,83060,2020-10-04,5,2,75,38,2,Kärnten,7,40,5.0
1862,277858,2020-10-04,64,15,1732,155,3,Niederösterreich,79,170,8.8
1863,214919,2020-10-04,42,4,1924,49,4,Oberösterreich,46,53,7.5
1864,87797,2020-10-04,12,0,90,4,5,Salzburg,12,4,0.0
1865,162945,2020-10-04,29,11,1356,90,6,Steiermark,40,101,10.9
1866,238640,2020-10-04,24,5,60,65,7,Tirol,29,70,7.1
1867,95290,2020-10-04,18,5,66,12,8,Vorarlberg,23,17,29.4
1868,475755,2020-10-04,168,57,2215,247,9,Wien,225,304,18.8
1869,1686373,2020-10-04,373,103,7879,674,10,Alle,476,777,13.3
1870,50283,2020-10-05,14,2,328,15,1,Burgenland,16,17,11.8
1871,83251,2020-10-05,6,2,74,38,2,Kärnten,8,40,5.0
1872,280640,2020-10-05,67,15,2612,155,3,Niederösterreich,82,170,8.8
1873,218323,2020-10-05,39,5,2569,80,4,Oberösterreich,44,85,5.9
1874,88215,2020-10-05,11,1,91,3,5,Salzburg,12,4,25.0
1875,163011,2020-10-05,32,11,1428,101,6,Steiermark,43,112,9.8
1876,239498,2020-10-05,24,5,60,65,7,Tirol,29,70,7.1
1877,96312,2020-10-05,13,5,66,12,8,Vorarlberg,18,17,29.4
1878,478735,2020-10-05,181,55,2341,265,9,Wien,236,320,17.2
1879,1698268,2020-10-05,387,101,9569,734,10,Alle,488,835,12.1
1880,51576,2020-10-06,10,4,308,17,1,Burgenland,14,21,19.0
1881,83925,2020-10-06,8,2,72,38,2,Kärnten,10,40,5.0
1882,283329,2020-10-06,71,17,2602,153,3,Niederösterreich,88,170,10.0
1883,219940,2020-10-06,48,5,1952,67,4,Oberösterreich,53,72,6.9
1884,89055,2020-10-06,12,1,90,3,5,Salzburg,13,4,25.0
1885,165584,2020-10-06,35,12,1069,86,6,Steiermark,47,98,12.2
1886,240971,2020-10-06,19,3,63,81,7,Tirol,22,84,3.6
1887,97220,2020-10-06,13,5,66,12,8,Vorarlberg,18,17,29.4
1888,484905,2020-10-06,181,52,2134,269,9,Wien,233,321,16.2
1889,1716505,2020-10-06,397,101,8356,726,10,Alle,498,827,12.2
1890,52368,2020-10-07,9,5,274,17,1,Burgenland,14,22,22.7
1891,84705,2020-10-07,9,1,71,39,2,Kärnten,10,40,2.5
1892,285846,2020-10-07,76,14,1752,156,3,Niederösterreich,90,170,8.2
1893,222197,2020-10-07,48,5,1815,67,4,Oberösterreich,53,72,6.9
1894,89963,2020-10-07,14,1,88,3,5,Salzburg,15,4,25.0
1895,167346,2020-10-07,31,10,967,68,6,Steiermark,41,78,12.8
1896,243540,2020-10-07,23,3,49,12,7,Tirol,26,15,20.0
1897,98017,2020-10-07,13,4,67,8,8,Vorarlberg,17,12,33.3
1898,491112,2020-10-07,202,57,2004,251,9,Wien,259,308,18.5
1899,1735094,2020-10-07,425,100,7087,621,10,Alle,525,721,13.9
1900,52832,2020-10-08,9,5,287,17,1,Burgenland,14,22,22.7
1901,85501,2020-10-08,9,2,71,98,2,Kärnten,11,100,2.0
1902,289066,2020-10-08,73,14,1546,156,3,Niederösterreich,87,170,8.2
1903,224371,2020-10-08,49,5,1829,57,4,Oberösterreich,54,62,8.1
1904,91634,2020-10-08,14,1,88,3,5,Salzburg,15,4,25.0
1905,169436,2020-10-08,31,10,967,68,6,Steiermark,41,78,12.8
1906,245706,2020-10-08,25,3,53,12,7,Tirol,28,15,20.0
1907,98888,2020-10-08,13,4,67,8,8,Vorarlberg,17,12,33.3
1908,499422,2020-10-08,176,63,1880,246,9,Wien,239,309,20.4
1909,1756856,2020-10-08,399,107,6788,665,10,Alle,506,772,13.9
1910,54075,2020-10-09,6,5,257,13,1,Burgenland,11,18,27.8
1911,87604,2020-10-09,9,2,71,38,2,Kärnten,11,40,5.0
1912,291469,2020-10-09,74,16,1383,154,3,Niederösterreich,90,170,9.4
1913,226649,2020-10-09,53,4,1840,69,4,Oberösterreich,57,73,5.5
1914,92377,2020-10-09,16,1,86,3,5,Salzburg,17,4,25.0
1915,172004,2020-10-09,36,5,913,85,6,Steiermark,41,90,5.6
1916,247667,2020-10-09,25,3,59,12,7,Tirol,28,15,20.0
1917,100172,2020-10-09,10,7,67,6,8,Vorarlberg,17,13,53.8
1918,503414,2020-10-09,176,60,1951,247,9,Wien,236,307,19.5
1919,1775431,2020-10-09,405,103,6627,627,10,Alle,508,730,14.1
1920,54437,2020-10-10,7,6,310,17,1,Burgenland,13,23,26.1
1921,88356,2020-10-10,11,2,69,38,2,Kärnten,13,40,5.0
1922,294868,2020-10-10,70,14,1413,156,3,Niederösterreich,84,170,8.2
1923,228714,2020-10-10,53,4,1840,69,4,Oberösterreich,57,73,5.5
1924,93704,2020-10-10,17,1,85,44,5,Salzburg,18,45,2.2
1925,174525,2020-10-10,40,6,1015,95,6,Steiermark,46,101,5.9
1926,249588,2020-10-10,23,7,49,9,7,Tirol,30,16,43.8
1927,101781,2020-10-10,14,6,64,8,8,Vorarlberg,20,14,42.9
1928,509414,2020-10-10,175,53,2004,264,9,Wien,228,317,16.7
1929,1795387,2020-10-10,410,99,6849,700,10,Alle,509,799,12.4
1930,55106,2020-10-11,7,6,322,23,1,Burgenland,13,29,20.7
1931,88566,2020-10-11,8,2,72,38,2,Kärnten,10,40,5.0
1932,297659,2020-10-11,73,13,1689,157,3,Niederösterreich,86,170,7.6
1933,230231,2020-10-11,53,4,1840,69,4,Oberösterreich,57,73,5.5
1934,94191,2020-10-11,22,2,76,43,5,Salzburg,24,45,4.4
1935,175745,2020-10-11,44,5,1397,91,6,Steiermark,49,96,5.2
1936,251328,2020-10-11,23,7,49,9,7,Tirol,30,16,43.8
1937,103080,2020-10-11,20,6,64,8,8,Vorarlberg,26,14,42.9
1938,513357,2020-10-11,181,51,2241,285,9,Wien,232,336,15.2
1939,1809263,2020-10-11,431,96,7750,723,10,Alle,527,819,11.7
1940,55492,2020-10-12,11,4,304,23,1,Burgenland,15,27,14.8
1941,88853,2020-10-12,10,2,70,38,2,Kärnten,12,40,5.0
1942,299725,2020-10-12,70,13,2537,157,3,Niederösterreich,83,170,7.6
1943,233607,2020-10-12,63,7,2644,72,4,Oberösterreich,70,79,8.9
1944,94730,2020-10-12,21,2,77,43,5,Salzburg,23,45,4.4
1945,177313,2020-10-12,44,7,1473,86,6,Steiermark,51,93,7.5
1946,252527,2020-10-12,23,7,49,9,7,Tirol,30,16,43.8
1947,104286,2020-10-12,20,6,64,8,8,Vorarlberg,26,14,42.9
1948,516398,2020-10-12,202,49,2292,277,9,Wien,251,326,15.0
1949,1822931,2020-10-12,464,97,9510,713,10,Alle,561,810,12.0
1950,55779,2020-10-13,12,4,270,21,1,Burgenland,16,25,16.0
1951,89664,2020-10-13,9,2,71,38,2,Kärnten,11,40,5.0
1952,302515,2020-10-13,83,18,2540,152,3,Niederösterreich,101,170,10.6
1953,235197,2020-10-13,69,7,2116,72,4,Oberösterreich,76,79,8.9
1954,95693,2020-10-13,28,1,70,44,5,Salzburg,29,45,2.2
1955,178888,2020-10-13,46,7,1079,77,6,Steiermark,53,84,8.3
1956,254271,2020-10-13,37,8,36,10,7,Tirol,45,18,44.4
1957,105354,2020-10-13,17,4,67,27,8,Vorarlberg,21,31,12.9
1958,527278,2020-10-13,203,56,2234,258,9,Wien,259,314,17.8
1959,1844639,2020-10-13,504,107,8483,699,10,Alle,611,806,13.3
1960,56187,2020-10-14,13,4,254,22,1,Burgenland,17,26,15.4
1961,90495,2020-10-14,10,2,70,38,2,Kärnten,12,40,5.0
1962,305198,2020-10-14,91,20,1714,150,3,Niederösterreich,111,170,11.8
1963,237453,2020-10-14,74,7,1889,64,4,Oberösterreich,81,71,9.9
1964,96797,2020-10-14,28,2,70,43,5,Salzburg,30,45,4.4
1965,180738,2020-10-14,55,9,950,85,6,Steiermark,64,94,9.6
1966,255973,2020-10-14,44,8,35,10,7,Tirol,52,18,44.4
1967,106030,2020-10-14,18,4,66,15,8,Vorarlberg,22,19,21.1
1968,532801,2020-10-14,209,56,2056,255,9,Wien,265,311,18.0
1969,1861672,2020-10-14,542,112,7104,682,10,Alle,654,794,14.1
1970,57997,2020-10-15,13,4,251,23,1,Burgenland,17,27,14.8
1971,91346,2020-10-15,10,2,70,38,2,Kärnten,12,40,5.0
1972,307330,2020-10-15,83,20,1441,150,3,Niederösterreich,103,170,11.8
1973,239513,2020-10-15,80,11,1846,61,4,Oberösterreich,91,72,15.3
1974,97777,2020-10-15,31,4,67,41,5,Salzburg,35,45,8.9
1975,182823,2020-10-15,60,12,882,90,6,Steiermark,72,102,11.8
1976,259232,2020-10-15,45,7,30,8,7,Tirol,52,15,46.7
1977,107118,2020-10-15,19,4,65,17,8,Vorarlberg,23,21,19.0
1978,538349,2020-10-15,204,55,1831,277,9,Wien,259,332,16.6
1979,1881485,2020-10-15,545,119,6483,705,10,Alle,664,824,14.4
1980,58645,2020-10-16,18,4,270,18,1,Burgenland,22,22,18.2
1981,93535,2020-10-16,11,2,69,38,2,Kärnten,13,40,5.0
1982,312078,2020-10-16,92,19,1271,151,3,Niederösterreich,111,170,11.2
1983,241698,2020-10-16,96,13,1920,60,4,Oberösterreich,109,73,17.8
1984,98891,2020-10-16,29,5,73,40,5,Salzburg,34,45,11.1
1985,185114,2020-10-16,64,12,902,98,6,Steiermark,76,110,10.9
1986,261099,2020-10-16,51,8,33,10,7,Tirol,59,18,44.4
1987,108195,2020-10-16,19,4,65,17,8,Vorarlberg,23,21,19.0
1988,538349,2020-10-16,204,55,1831,277,9,Wien,259,332,16.6
1989,1897604,2020-10-16,584,122,6434,709,10,Alle,706,831,14.7
1990,62627,2020-10-17,18,4,351,69,1,Burgenland,22,73,5.5
1991,94104,2020-10-17,9,2,71,38,2,Kärnten,11,40,5.0
1992,316800,2020-10-17,100,21,1327,149,3,Niederösterreich,121,170,12.4
1993,243541,2020-10-17,104,14,2482,75,4,Oberösterreich,118,89,15.7
1994,101178,2020-10-17,38,5,71,40,5,Salzburg,43,45,11.1
1995,186282,2020-10-17,64,15,929,88,6,Steiermark,79,103,14.6
1996,264968,2020-10-17,46,7,39,11,7,Tirol,53,18,38.9
1997,110142,2020-10-17,19,5,65,7,8,Vorarlberg,24,12,41.7
1998,543071,2020-10-17,196,57,1867,231,9,Wien,253,288,19.8
1999,1922713,2020-10-17,594,130,7202,708,10,Alle,724,838,15.5
2000,60141,2020-10-18,17,5,381,21,1,Burgenland,22,26,19.2
2001,94311,2020-10-18,10,2,70,38,2,Kärnten,12,40,5.0
2002,318846,2020-10-18,93,22,1515,148,3,Niederösterreich,115,170,12.9
2003,245151,2020-10-18,118,16,2845,79,4,Oberösterreich,134,95,16.8
2004,102562,2020-10-18,34,5,75,40,5,Salzburg,39,45,11.1
2005,188162,2020-10-18,60,16,1324,99,6,Steiermark,76,115,13.9
2006,266936,2020-10-18,46,7,39,11,7,Tirol,53,18,38.9
2007,112147,2020-10-18,14,5,58,7,8,Vorarlberg,19,12,41.7
2008,549772,2020-10-18,215,57,2226,251,9,Wien,272,308,18.5
2009,1938028,2020-10-18,607,135,8533,694,10,Alle,742,829,16.3
2010,60416,2020-10-19,22,5,293,17,1,Burgenland,27,22,22.7
2011,94592,2020-10-19,14,3,66,37,2,Kärnten,17,40,7.5
2012,323137,2020-10-19,101,26,2395,144,3,Niederösterreich,127,170,15.3
2013,248228,2020-10-19,141,16,2587,86,4,Oberösterreich,157,102,15.7
2014,103442,2020-10-19,31,5,78,40,5,Salzburg,36,45,11.1
2015,189023,2020-10-19,72,16,1379,103,6,Steiermark,88,119,13.4
2016,267857,2020-10-19,46,7,39,11,7,Tirol,53,18,38.9
2017,113560,2020-10-19,14,5,58,7,8,Vorarlberg,19,12,41.7
2018,552323,2020-10-19,213,62,2282,242,9,Wien,275,304,20.4
2019,1952578,2020-10-19,654,145,9177,687,10,Alle,799,832,17.4
2020,60750,2020-10-20,20,4,282,12,1,Burgenland,24,16,25.0
2021,95081,2020-10-20,17,3,63,37,2,Kärnten,20,40,7.5
2022,326005,2020-10-20,110,22,2414,148,3,Niederösterreich,132,170,12.9
2023,250069,2020-10-20,154,19,2034,76,4,Oberösterreich,173,95,20.0
2024,104853,2020-10-20,45,4,64,41,5,Salzburg,49,45,8.9
2025,192341,2020-10-20,88,19,1118,100,6,Steiermark,107,119,16.0
2026,271062,2020-10-20,68,11,32,8,7,Tirol,79,19,57.9
2027,114577,2020-10-20,23,6,40,15,8,Vorarlberg,29,21,28.6
2028,557309,2020-10-20,219,57,2160,256,9,Wien,276,313,18.2
2029,1972047,2020-10-20,744,145,8207,693,10,Alle,889,838,17.3
2030,61246,2020-10-21,24,4,269,16,1,Burgenland,28,20,20.0
2031,95953,2020-10-21,25,3,55,37,2,Kärnten,28,40,7.5
2032,330551,2020-10-21,118,25,1602,145,3,Niederösterreich,143,170,14.7
2033,252446,2020-10-21,163,19,1931,61,4,Oberösterreich,182,80,23.8
2034,107024,2020-10-21,53,4,56,41,5,Salzburg,57,45,8.9
2035,194654,2020-10-21,99,17,863,89,6,Steiermark,116,106,16.0
2036,273376,2020-10-21,81,8,22,10,7,Tirol,89,18,44.4
2037,115128,2020-10-21,25,7,37,15,8,Vorarlberg,32,22,31.8
2038,562746,2020-10-21,225,60,2034,227,9,Wien,285,287,20.9
2039,1993124,2020-10-21,813,147,6869,641,10,Alle,960,788,18.7
2040,61631,2020-10-22,25,5,292,18,1,Burgenland,30,23,21.7
2041,96733,2020-10-22,27,2,53,38,2,Kärnten,29,40,5.0
2042,335649,2020-10-22,121,25,1402,145,3,Niederösterreich,146,170,14.7
2043,255451,2020-10-22,177,18,1995,55,4,Oberösterreich,195,73,24.7
2044,108705,2020-10-22,48,10,61,35,5,Salzburg,58,45,22.2
2045,197076,2020-10-22,97,18,969,88,6,Steiermark,115,106,17.0
2046,277272,2020-10-22,87,8,33,11,7,Tirol,95,19,42.1
2047,115952,2020-10-22,30,8,34,12,8,Vorarlberg,38,20,40.0
2048,569933,2020-10-22,229,67,1961,225,9,Wien,296,292,22.9
2049,2018402,2020-10-22,841,161,6800,627,10,Alle,1002,788,20.4
2050,62054,2020-10-23,27,4,280,18,1,Burgenland,31,22,18.2
2051,99065,2020-10-23,28,2,52,38,2,Kärnten,30,40,5.0
2052,341165,2020-10-23,133,23,1253,147,3,Niederösterreich,156,170,13.5
2053,258693,2020-10-23,190,21,2025,64,4,Oberösterreich,211,85,24.7
2054,110632,2020-10-23,63,8,46,37,5,Salzburg,71,45,17.8
2055,199831,2020-10-23,106,21,887,87,6,Steiermark,127,108,19.4
2056,280370,2020-10-23,91,8,28,11,7,Tirol,99,19,42.1
2057,117119,2020-10-23,31,9,36,8,8,Vorarlberg,40,17,52.9
2058,577497,2020-10-23,231,62,1972,218,9,Wien,293,280,22.1
2059,2046426,2020-10-23,900,158,6579,628,10,Alle,1058,786,20.1
2060,62636,2020-10-24,27,4,360,16,1,Burgenland,31,20,20.0
2061,99791,2020-10-24,29,3,51,37,2,Kärnten,32,40,7.5
2062,345280,2020-10-24,134,24,1238,146,3,Niederösterreich,158,170,14.1
2063,261789,2020-10-24,239,24,2664,55,4,Oberösterreich,263,79,30.4
2064,111683,2020-10-24,68,11,48,34,5,Salzburg,79,45,24.4
2065,202767,2020-10-24,134,21,1014,93,6,Steiermark,155,114,18.4
2066,283126,2020-10-24,99,8,37,11,7,Tirol,107,19,42.1
2067,118567,2020-10-24,32,11,32,9,8,Vorarlberg,43,20,55.0
2068,584976,2020-10-24,240,69,2114,236,9,Wien,309,305,22.6
2069,2070615,2020-10-24,1002,175,7558,637,10,Alle,1177,812,21.6
2070,64395,2020-10-25,27,3,393,14,1,Burgenland,30,17,17.6
2071,100058,2020-10-25,40,3,40,37,2,Kärnten,43,40,7.5
2072,346917,2020-10-25,126,28,1452,142,3,Niederösterreich,154,170,16.5
2073,264424,2020-10-25,257,25,2967,83,4,Oberösterreich,282,108,23.1
2074,112986,2020-10-25,74,11,35,34,5,Salzburg,85,45,24.4
2075,204392,2020-10-25,144,19,1520,102,6,Steiermark,163,121,15.7
2076,284908,2020-10-25,99,8,37,11,7,Tirol,107,19,42.1
2077,120047,2020-10-25,32,11,32,9,8,Vorarlberg,43,20,55.0
2078,590232,2020-10-25,252,66,2307,231,9,Wien,318,297,22.2
2079,2088359,2020-10-25,1051,174,8783,663,10,Alle,1225,837,20.8
2080,64980,2020-10-26,27,5,375,16,1,Burgenland,32,21,23.8
2081,100391,2020-10-26,44,4,56,36,2,Kärnten,48,40,10.0
2082,350675,2020-10-26,148,27,2379,143,3,Niederösterreich,175,170,15.9
2083,269150,2020-10-26,289,27,3034,74,4,Oberösterreich,316,101,26.7
2084,114482,2020-10-26,70,13,70,32,5,Salzburg,83,45,28.9
2085,206087,2020-10-26,152,25,1668,102,6,Steiermark,177,127,19.7
2086,286583,2020-10-26,107,8,37,11,7,Tirol,115,19,42.1
2087,122408,2020-10-26,32,11,32,9,8,Vorarlberg,43,20,55.0
2088,596819,2020-10-26,273,68,2393,228,9,Wien,341,296,23.0
2089,2111575,2020-10-26,1142,188,10044,651,10,Alle,1330,839,22.4
2090,65330,2020-10-27,26,4,351,14,1,Burgenland,30,18,22.2
2091,100854,2020-10-27,50,3,50,37,2,Kärnten,53,40,7.5
2092,352893,2020-10-27,153,30,2648,140,3,Niederösterreich,183,170,17.6
2093,270480,2020-10-27,302,30,2845,78,4,Oberösterreich,332,108,27.8
2094,115234,2020-10-27,75,13,65,32,5,Salzburg,88,45,28.9
2095,207552,2020-10-27,177,29,1665,98,6,Steiermark,206,127,22.8
2096,288514,2020-10-27,99,8,37,11,7,Tirol,107,19,42.1
2097,122623,2020-10-27,32,11,32,9,8,Vorarlberg,43,20,55.0
2098,602207,2020-10-27,283,75,2417,232,9,Wien,358,307,24.4
2099,2125687,2020-10-27,1197,203,10110,651,10,Alle,1400,854,23.8
2100,65987,2020-10-28,27,4,300,12,1,Burgenland,31,16,25.0
2101,102081,2020-10-28,52,3,68,37,2,Kärnten,55,40,7.5
2102,357650,2020-10-28,191,37,2425,133,3,Niederösterreich,228,170,21.8
2103,274579,2020-10-28,328,33,2279,70,4,Oberösterreich,361,103,32.0
2104,117233,2020-10-28,75,11,65,34,5,Salzburg,86,45,24.4
2105,211278,2020-10-28,194,31,1226,98,6,Steiermark,225,129,24.0
2106,291225,2020-10-28,134,18,30,7,7,Tirol,152,25,72.0
2107,123739,2020-10-28,58,11,374,23,8,Vorarlberg,69,34,32.4
2108,609294,2020-10-28,286,76,2450,215,9,Wien,362,291,26.1
2109,2153066,2020-10-28,1345,224,9217,629,10,Alle,1569,853,26.3
2110,66879,2020-10-29,30,4,310,15,1,Burgenland,34,19,21.1
2111,102939,2020-10-29,64,4,56,36,2,Kärnten,68,40,10.0
2112,361663,2020-10-29,195,42,1707,128,3,Niederösterreich,237,170,24.7
2113,279477,2020-10-29,344,35,2229,63,4,Oberösterreich,379,98,35.7
2114,118411,2020-10-29,84,12,56,33,5,Salzburg,96,45,26.7
2115,214349,2020-10-29,214,38,1060,97,6,Steiermark,252,135,28.1
2116,294088,2020-10-29,140,19,27,5,7,Tirol,159,24,79.2
2117,124496,2020-10-29,57,12,375,24,8,Vorarlberg,69,36,33.3
2118,615270,2020-10-29,316,82,2202,225,9,Wien,398,307,26.7
2119,2177572,2020-10-29,1444,248,8022,626,10,Alle,1692,874,28.4
2120,68325,2020-10-30,29,4,317,16,1,Burgenland,33,20,20.0
2121,104065,2020-10-30,71,6,49,34,2,Kärnten,77,40,15.0
2122,365418,2020-10-30,220,46,1445,124,3,Niederösterreich,266,170,27.1
2123,283545,2020-10-30,369,31,2314,74,4,Oberösterreich,400,105,29.5
2124,120647,2020-10-30,91,13,37,32,5,Salzburg,104,45,28.9
2125,218513,2020-10-30,233,39,1000,88,6,Steiermark,272,127,30.7
2126,296914,2020-10-30,140,24,40,5,7,Tirol,164,29,82.8
2127,125120,2020-10-30,67,14,365,22,8,Vorarlberg,81,36,38.9
2128,621446,2020-10-30,320,86,2095,231,9,Wien,406,317,27.1
2129,2203993,2020-10-30,1540,263,7662,626,10,Alle,1803,889,29.6
2130,69121,2020-10-31,28,4,385,17,1,Burgenland,32,21,19.0
2131,106547,2020-10-31,77,6,43,34,2,Kärnten,83,40,15.0
2132,370635,2020-10-31,251,43,1531,127,3,Niederösterreich,294,170,25.3
2133,287337,2020-10-31,401,36,2883,68,4,Oberösterreich,437,104,34.6
2134,122338,2020-10-31,91,15,51,30,5,Salzburg,106,45,33.3
2135,222556,2020-10-31,246,36,1181,94,6,Steiermark,282,130,27.7
2136,300358,2020-10-31,140,24,40,5,7,Tirol,164,29,82.8
2137,126685,2020-10-31,67,14,365,22,8,Vorarlberg,81,36,38.9
2138,627158,2020-10-31,301,87,2199,258,9,Wien,388,345,25.2
2139,2232735,2020-10-31,1602,265,8678,655,10,Alle,1867,920,28.8
2140,69812,2020-11-01,26,5,424,13,1,Burgenland,31,18,27.8
2141,107350,2020-11-01,79,5,41,35,2,Kärnten,84,40,12.5
2142,374337,2020-11-01,256,43,1732,127,3,Niederösterreich,299,170,25.3
2143,290908,2020-11-01,416,47,3180,86,4,Oberösterreich,463,133,35.3
2144,123930,2020-11-01,92,17,54,28,5,Salzburg,109,45,37.8
2145,224199,2020-11-01,252,47,1641,77,6,Steiermark,299,124,37.9
2146,302388,2020-11-01,141,28,47,5,7,Tirol,169,33,84.8
2147,127997,2020-11-01,67,18,365,16,8,Vorarlberg,85,34,52.9
2148,635130,2020-11-01,328,81,2402,266,9,Wien,409,347,23.3
2149,2256051,2020-11-01,1657,291,9886,653,10,Alle,1948,944,30.8
2150,70798,2020-11-02,25,7,385,18,1,Burgenland,32,25,28.0
2151,107718,2020-11-02,90,9,30,31,2,Kärnten,99,40,22.5
2152,378535,2020-11-02,279,44,2562,126,3,Niederösterreich,323,170,25.9
2153,296960,2020-11-02,473,57,2996,74,4,Oberösterreich,530,131,43.5
2154,125686,2020-11-02,101,17,45,28,5,Salzburg,118,45,37.8
2155,226326,2020-11-02,264,53,1703,85,6,Steiermark,317,138,38.4
2156,304352,2020-11-02,141,28,47,5,7,Tirol,169,33,84.8
2157,129296,2020-11-02,92,22,358,12,8,Vorarlberg,114,34,64.7
2158,639830,2020-11-02,360,99,2255,251,9,Wien,459,350,28.3
2159,2279501,2020-11-02,1825,336,10381,630,10,Alle,2161,966,34.8
2160,72064,2020-11-03,32,8,355,15,1,Burgenland,40,23,34.8
2161,108928,2020-11-03,94,10,56,30,2,Kärnten,104,40,25.0
2162,383638,2020-11-03,321,51,2662,119,3,Niederösterreich,372,170,30.0
2163,300556,2020-11-03,533,60,2523,65,4,Oberösterreich,593,125,48.0
2164,126835,2020-11-03,97,20,64,25,5,Salzburg,117,45,44.4
2165,230544,2020-11-03,299,56,1641,87,6,Steiermark,355,143,39.2
2166,306572,2020-11-03,190,36,68,5,7,Tirol,226,41,87.8
2167,130441,2020-11-03,116,22,316,19,8,Vorarlberg,138,41,53.7
2168,645804,2020-11-03,383,103,2170,240,9,Wien,486,343,30.0
2169,2305382,2020-11-03,2065,366,9855,605,10,Alle,2431,971,37.7
2170,73003,2020-11-04,38,8,306,17,1,Burgenland,46,25,32.0
2171,110212,2020-11-04,95,11,70,29,2,Kärnten,106,40,27.5
2172,387664,2020-11-04,370,50,1986,85,3,Niederösterreich,420,135,37.0
2173,305338,2020-11-04,547,61,2420,62,4,Oberösterreich,608,123,49.6
2174,129376,2020-11-04,104,21,56,24,5,Salzburg,125,45,46.7
2175,234146,2020-11-04,362,58,1381,88,6,Steiermark,420,146,39.7
2176,311721,2020-11-04,198,39,56,5,7,Tirol,237,44,88.6
2177,131379,2020-11-04,108,25,324,15,8,Vorarlberg,133,40,62.5
2178,651976,2020-11-04,379,110,2060,228,9,Wien,489,338,32.5
2179,2334815,2020-11-04,2201,383,8659,553,10,Alle,2584,936,40.9
2180,74154,2020-11-05,45,13,320,17,1,Burgenland,58,30,43.3
2181,112135,2020-11-05,105,10,60,30,2,Kärnten,115,40,25.0
2182,392604,2020-11-05,384,59,1722,101,3,Niederösterreich,443,160,36.9
2183,309174,2020-11-05,593,71,3113,41,4,Oberösterreich,664,112,63.4
2184,131012,2020-11-05,105,22,57,23,5,Salzburg,127,45,48.9
2185,237796,2020-11-05,393,61,1428,86,6,Steiermark,454,147,41.5
2186,315130,2020-11-05,213,39,67,8,7,Tirol,252,47,83.0
2187,132566,2020-11-05,108,25,324,15,8,Vorarlberg,133,40,62.5
2188,658377,2020-11-05,384,107,2060,228,9,Wien,491,335,31.9
2189,2362948,2020-11-05,2330,407,9151,549,10,Alle,2737,956,42.6
2190,75130,2020-11-06,47,10,293,16,1,Burgenland,57,26,38.5
2191,114365,2020-11-06,117,11,48,29,2,Kärnten,128,40,27.5
2192,397922,2020-11-06,387,61,1613,106,3,Niederösterreich,448,167,36.5
2193,313094,2020-11-06,659,79,91,21,4,Oberösterreich,738,100,79.0
2194,132857,2020-11-06,117,21,49,24,5,Salzburg,138,45,46.7
2195,245277,2020-11-06,420,66,1630,77,6,Steiermark,486,143,46.2
2196,319681,2020-11-06,219,44,84,9,7,Tirol,263,53,83.0
2197,133723,2020-11-06,117,28,315,10,8,Vorarlberg,145,38,73.7
2198,663966,2020-11-06,421,111,1823,288,9,Wien,532,399,27.8
2199,2396015,2020-11-06,2504,431,5946,580,10,Alle,2935,1011,42.6
2200,77182,2020-11-07,53,14,45,4,1,Burgenland,67,18,77.8
2201,115501,2020-11-07,132,11,33,29,2,Kärnten,143,40,27.5
2202,404984,2020-11-07,411,58,1632,102,3,Niederösterreich,469,160,36.2
2203,318146,2020-11-07,670,86,80,14,4,Oberösterreich,756,100,86.0
2204,133519,2020-11-07,112,23,83,22,5,Salzburg,135,45,51.1
2205,247164,2020-11-07,433,59,1475,96,6,Steiermark,492,155,38.1
2206,323454,2020-11-07,231,44,85,12,7,Tirol,275,56,78.6
2207,134874,2020-11-07,116,22,316,19,8,Vorarlberg,138,41,53.7
2208,671001,2020-11-07,416,115,1919,217,9,Wien,531,332,34.6
2209,2425825,2020-11-07,2574,432,5668,515,10,Alle,3006,947,45.6
2210,78094,2020-11-08,61,14,126,11,1,Burgenland,75,25,56.0
2211,116960,2020-11-08,133,12,32,28,2,Kärnten,145,40,30.0
2212,410315,2020-11-08,395,57,1887,106,3,Niederösterreich,452,163,35.0
2213,321745,2020-11-08,694,91,56,9,4,Oberösterreich,785,100,91.0
2214,133993,2020-11-08,121,25,74,20,5,Salzburg,146,45,55.6
2215,250936,2020-11-08,401,63,1862,87,6,Steiermark,464,150,42.0
2216,328270,2020-11-08,215,48,89,10,7,Tirol,263,58,82.8
2217,136641,2020-11-08,113,27,319,15,8,Vorarlberg,140,42,64.3
2218,675738,2020-11-08,400,122,1919,217,9,Wien,522,339,36.0
2219,2452692,2020-11-08,2533,459,6364,503,10,Alle,2992,962,47.7
2220,78592,2020-11-09,72,14,42,5,1,Burgenland,86,19,73.7
2221,117805,2020-11-09,151,14,39,26,2,Kärnten,165,40,35.0
2222,415460,2020-11-09,406,58,2671,123,3,Niederösterreich,464,181,32.0
2223,328180,2020-11-09,740,98,460,52,4,Oberösterreich,838,150,65.3
2224,134453,2020-11-09,141,22,53,23,5,Salzburg,163,45,48.9
2225,255472,2020-11-09,416,64,1894,101,6,Steiermark,480,165,38.8
2226,329704,2020-11-09,228,50,81,10,7,Tirol,278,60,83.3
2227,137602,2020-11-09,171,29,319,13,8,Vorarlberg,200,42,69.0
2228,681800,2020-11-09,430,124,2081,211,9,Wien,554,335,37.0
2229,2479068,2020-11-09,2755,473,7640,564,10,Alle,3228,1037,45.6
2230,79207,2020-11-10,72,10,34,19,1,Burgenland,82,29,34.5
2231,118944,2020-11-10,163,14,36,26,2,Kärnten,177,40,35.0
2232,420285,2020-11-10,464,65,2720,124,3,Niederösterreich,529,189,34.4
2233,331255,2020-11-10,803,101,397,49,4,Oberösterreich,904,150,67.3
2234,135597,2020-11-10,142,22,52,23,5,Salzburg,164,45,48.9
2235,258149,2020-11-10,493,71,1619,106,6,Steiermark,564,177,40.1
2236,335074,2020-11-10,269,56,45,10,7,Tirol,325,66,84.8
2237,138660,2020-11-10,177,30,285,18,8,Vorarlberg,207,48,62.5
2238,688437,2020-11-10,471,126,1896,205,9,Wien,597,331,38.1
2239,2505608,2020-11-10,3054,495,7084,580,10,Alle,3549,1075,46.0
2240,80521,2020-11-11,82,11,49,16,1,Burgenland,93,27,40.7
2241,120698,2020-11-11,205,17,24,23,2,Kärnten,222,40,42.5
2242,425309,2020-11-11,472,66,2142,118,3,Niederösterreich,538,184,35.9
2243,335807,2020-11-11,825,113,375,37,4,Oberösterreich,938,150,75.3
2244,135958,2020-11-11,142,22,52,23,5,Salzburg,164,45,48.9
2245,262525,2020-11-11,504,73,1504,86,6,Steiermark,577,159,45.9
2246,340214,2020-11-11,288,55,61,11,7,Tirol,343,66,83.3
2247,140562,2020-11-11,148,38,284,18,8,Vorarlberg,186,56,67.9
2248,695585,2020-11-11,517,141,1844,210,9,Wien,658,351,40.2
2249,2537179,2020-11-11,3183,536,6335,542,10,Alle,3719,1078,49.7
2250,81412,2020-11-12,91,12,39,15,1,Burgenland,103,27,44.4
2251,121848,2020-11-12,229,20,28,20,2,Kärnten,249,40,50.0
2252,430307,2020-11-12,495,69,2037,121,3,Niederösterreich,564,190,36.3
2253,340176,2020-11-12,846,112,354,38,4,Oberösterreich,958,150,74.7
2254,145392,2020-11-12,139,24,55,21,5,Salzburg,163,45,53.3
2255,266456,2020-11-12,506,82,1527,86,6,Steiermark,588,168,48.8
2256,344088,2020-11-12,294,54,78,13,7,Tirol,348,67,80.6
2257,142514,2020-11-12,144,38,288,14,8,Vorarlberg,182,52,73.1
2258,703212,2020-11-12,521,135,1833,212,9,Wien,656,347,38.9
2259,2575405,2020-11-12,3265,546,6239,540,10,Alle,3811,1086,50.3
2260,82282,2020-11-13,87,13,80,14,1,Burgenland,100,27,48.1
2261,124095,2020-11-13,252,22,50,18,2,Kärnten,274,40,55.0
2262,435301,2020-11-13,489,75,531,107,3,Niederösterreich,564,182,41.2
2263,344824,2020-11-13,861,121,339,29,4,Oberösterreich,982,150,80.7
2264,147886,2020-11-13,150,22,44,23,5,Salzburg,172,45,48.9
2265,270202,2020-11-13,521,93,1558,73,6,Steiermark,614,166,56.0
2266,348458,2020-11-13,300,52,76,12,7,Tirol,352,64,81.2
2267,144065,2020-11-13,148,35,284,17,8,Vorarlberg,183,52,67.3
2268,710620,2020-11-13,547,134,1832,229,9,Wien,681,363,36.9
2269,2607733,2020-11-13,3355,567,4794,522,10,Alle,3922,1089,52.1
2270,83179,2020-11-14,87,12,85,15,1,Burgenland,99,27,44.4
2271,125352,2020-11-14,257,22,53,38,2,Kärnten,279,60,36.7
2272,442303,2020-11-14,530,79,490,103,3,Niederösterreich,609,182,43.4
2273,348465,2020-11-14,847,117,353,33,4,Oberösterreich,964,150,78.0
2274,147886,2020-11-14,150,22,44,23,5,Salzburg,172,45,48.9
2275,275555,2020-11-14,564,103,1560,69,6,Steiermark,667,172,59.9
2276,351697,2020-11-14,292,51,89,17,7,Tirol,343,68,75.0
2277,148496,2020-11-14,148,35,284,17,8,Vorarlberg,183,52,67.3
2278,717867,2020-11-14,550,140,1964,250,9,Wien,690,390,35.9
2279,2640800,2020-11-14,3425,581,4922,565,10,Alle,4006,1146,50.7
2280,84015,2020-11-15,89,13,109,14,1,Burgenland,102,27,48.1
2281,126865,2020-11-15,269,24,43,36,2,Kärnten,293,60,40.0
2282,448050,2020-11-15,557,76,463,109,3,Niederösterreich,633,185,41.1
2283,349722,2020-11-15,866,121,334,29,4,Oberösterreich,987,150,80.7
2284,149949,2020-11-15,167,25,61,20,5,Salzburg,192,45,55.6
2285,278463,2020-11-15,656,96,1832,88,6,Steiermark,752,184,52.2
2286,356329,2020-11-15,281,58,107,10,7,Tirol,339,68,85.3
2287,148496,2020-11-15,148,35,284,17,8,Vorarlberg,183,52,67.3
2288,725991,2020-11-15,546,151,2106,244,9,Wien,697,395,38.2
2289,2667880,2020-11-15,3579,599,5339,567,10,Alle,4178,1166,51.4
2290,85289,2020-11-16,92,17,89,10,1,Burgenland,109,27,63.0
2291,127387,2020-11-16,293,25,38,35,2,Kärnten,318,60,41.7
2292,454645,2020-11-16,582,79,438,118,3,Niederösterreich,661,197,40.1
2293,353046,2020-11-16,946,121,154,29,4,Oberösterreich,1067,150,80.7
2294,152266,2020-11-16,170,23,61,22,5,Salzburg,193,45,51.1
2295,281765,2020-11-16,578,101,1944,86,6,Steiermark,679,187,54.0
2296,359307,2020-11-16,295,62,91,8,7,Tirol,357,70,88.6
2297,149800,2020-11-16,148,35,284,17,8,Vorarlberg,183,52,67.3
2298,730607,2020-11-16,581,149,2302,248,9,Wien,730,397,37.5
2299,2694112,2020-11-16,3685,612,5401,573,10,Alle,4297,1185,51.6
2300,85932,2020-11-17,95,16,87,11,1,Burgenland,111,27,59.3
2301,128837,2020-11-17,333,34,38,26,2,Kärnten,367,60,56.7
2302,460113,2020-11-17,591,87,429,348,3,Niederösterreich,678,435,20.0
2303,357319,2020-11-17,965,129,235,21,4,Oberösterreich,1094,150,86.0
2304,154588,2020-11-17,179,23,52,22,5,Salzburg,202,45,51.1
2305,284909,2020-11-17,618,105,1687,79,6,Steiermark,723,184,57.1
2306,362739,2020-11-17,338,70,82,5,7,Tirol,408,75,93.3
2307,150659,2020-11-17,153,39,279,16,8,Vorarlberg,192,55,70.9
2308,738066,2020-11-17,595,155,2076,241,9,Wien,750,396,39.1
2309,2723162,2020-11-17,3867,658,4965,769,10,Alle,4525,1427,46.1
2310,86499,2020-11-18,93,18,80,12,1,Burgenland,111,30,60.0
2311,130851,2020-11-18,334,31,61,29,2,Kärnten,365,60,51.7
2312,465473,2020-11-18,593,97,427,117,3,Niederösterreich,690,214,45.3
2313,360961,2020-11-18,982,133,218,17,4,Oberösterreich,1115,150,88.7
2314,157464,2020-11-18,181,27,50,18,5,Salzburg,208,45,60.0
2315,289525,2020-11-18,631,110,268,45,6,Steiermark,741,155,71.0
2316,367379,2020-11-18,338,68,77,7,7,Tirol,406,75,90.7
2317,152455,2020-11-18,159,41,273,16,8,Vorarlberg,200,57,71.9
2318,745683,2020-11-18,599,157,2074,247,9,Wien,756,404,38.9
2319,2756290,2020-11-18,3910,682,3528,508,10,Alle,4592,1190,57.3
2320,87404,2020-11-19,89,18,89,15,1,Burgenland,107,33,54.5
2321,131987,2020-11-19,340,27,65,33,2,Kärnten,367,60,45.0
2322,470538,2020-11-19,604,97,416,103,3,Niederösterreich,701,200,48.5
2323,364648,2020-11-19,963,138,237,12,4,Oberösterreich,1101,150,92.0
2324,160081,2020-11-19,194,24,49,21,5,Salzburg,218,45,53.3
2325,293516,2020-11-19,640,109,363,42,6,Steiermark,749,151,72.2
2326,371845,2020-11-19,341,67,108,9,7,Tirol,408,76,88.2
2327,153710,2020-11-19,179,44,253,15,8,Vorarlberg,223,59,74.6
2328,753877,2020-11-19,581,159,1768,238,9,Wien,740,397,40.1
2329,2787606,2020-11-19,3931,683,3348,488,10,Alle,4614,1171,58.3
2330,88034,2020-11-20,92,19,84,14,1,Burgenland,111,33,57.6
2331,133357,2020-11-20,332,30,55,30,2,Kärnten,362,60,50.0
2332,477539,2020-11-20,614,102,406,99,3,Niederösterreich,716,201,50.7
2333,368459,2020-11-20,963,136,238,14,4,Oberösterreich,1099,150,90.7
2334,162493,2020-11-20,196,24,47,21,5,Salzburg,220,45,53.3
2335,296979,2020-11-20,641,113,361,40,6,Steiermark,754,153,73.9
2336,376136,2020-11-20,340,67,89,9,7,Tirol,407,76,88.2
2337,155666,2020-11-20,172,40,260,24,8,Vorarlberg,212,64,62.5
2338,762133,2020-11-20,592,156,1780,233,9,Wien,748,389,40.1
2339,2820796,2020-11-20,3942,687,3320,484,10,Alle,4629,1171,58.7
2340,88927,2020-11-21,97,19,84,12,1,Burgenland,116,31,61.3
2341,134378,2020-11-21,320,40,72,20,2,Kärnten,360,60,66.7
2342,483222,2020-11-21,606,100,414,94,3,Niederösterreich,706,194,51.5
2343,372597,2020-11-21,889,131,311,19,4,Oberösterreich,1020,150,87.3
2344,164235,2020-11-21,196,24,47,21,5,Salzburg,220,45,53.3
2345,301193,2020-11-21,653,112,346,43,6,Steiermark,765,155,72.3
2346,379266,2020-11-21,376,69,59,5,7,Tirol,445,74,93.2
2347,157560,2020-11-21,172,40,281,24,8,Vorarlberg,212,64,62.5
2348,770226,2020-11-21,591,162,1918,266,9,Wien,753,428,37.9
2349,2851604,2020-11-21,3900,697,3532,504,10,Alle,4597,1201,58.0
2350,89468,2020-11-22,85,18,93,13,1,Burgenland,103,31,58.1
2351,137200,2020-11-22,330,35,75,25,2,Kärnten,365,60,58.3
2352,488298,2020-11-22,593,102,427,92,3,Niederösterreich,695,194,52.6
2353,379005,2020-11-22,889,132,311,18,4,Oberösterreich,1021,150,88.0
2354,166558,2020-11-22,196,24,47,21,5,Salzburg,220,45,53.3
2355,303414,2020-11-22,603,116,394,39,6,Steiermark,719,155,74.8
2356,382560,2020-11-22,360,66,85,13,7,Tirol,426,79,83.5
2357,159852,2020-11-22,151,39,278,25,8,Vorarlberg,190,64,60.9
2358,775080,2020-11-22,568,151,2074,266,9,Wien,719,417,36.2
2359,2881435,2020-11-22,3775,683,3784,512,10,Alle,4458,1195,57.2
2360,90392,2020-11-23,90,14,82,17,1,Burgenland,104,31,45.2
2361,138037,2020-11-23,355,34,51,26,2,Kärnten,389,60,56.7
2362,494001,2020-11-23,589,105,431,97,3,Niederösterreich,694,202,52.0
2363,381029,2020-11-23,922,139,278,11,4,Oberösterreich,1061,150,92.7
2364,167082,2020-11-23,196,24,47,21,5,Salzburg,220,45,53.3
2365,304528,2020-11-23,619,121,378,34,6,Steiermark,740,155,78.1
2366,384230,2020-11-23,368,64,76,15,7,Tirol,432,79,81.0
2367,161538,2020-11-23,154,39,276,23,8,Vorarlberg,193,62,62.9
2368,781020,2020-11-23,570,145,2089,263,9,Wien,715,408,35.5
2369,2901857,2020-11-23,3863,685,3708,507,10,Alle,4548,1192,57.5
2370,91987,2020-11-24,99,16,87,16,1,Burgenland,115,32,50.0
2371,139758,2020-11-24,377,35,64,25,2,Kärnten,412,60,58.3
2372,498181,2020-11-24,601,108,419,100,3,Niederösterreich,709,208,51.9
2373,383582,2020-11-24,917,148,283,9,4,Oberösterreich,1065,157,94.3
2374,169616,2020-11-24,196,24,47,21,5,Salzburg,220,45,53.3
2375,308258,2020-11-24,632,121,367,34,6,Steiermark,753,155,78.1
2376,388066,2020-11-24,385,67,80,13,7,Tirol,452,80,83.8
2377,162602,2020-11-24,187,40,285,24,8,Vorarlberg,227,64,62.5
2378,787877,2020-11-24,591,145,1930,261,9,Wien,736,406,35.7
2379,2929927,2020-11-24,3985,704,3562,503,10,Alle,4689,1207,58.3
2380,92798,2020-11-25,101,20,88,11,1,Burgenland,121,31,64.5
2381,141010,2020-11-25,379,37,65,23,2,Kärnten,416,60,61.7
2382,503189,2020-11-25,562,115,458,85,3,Niederösterreich,677,200,57.5
2383,386723,2020-11-25,895,148,305,9,4,Oberösterreich,1043,157,94.3
2384,171843,2020-11-25,196,24,47,21,5,Salzburg,220,45,53.3
2385,311911,2020-11-25,649,117,348,38,6,Steiermark,766,155,75.5
2386,391622,2020-11-25,362,70,121,13,7,Tirol,432,83,84.3
2387,164051,2020-11-25,138,36,294,28,8,Vorarlberg,174,64,56.2
2388,797349,2020-11-25,585,142,1926,258,9,Wien,727,400,35.5
2389,2960496,2020-11-25,3867,709,3652,486,10,Alle,4576,1195,59.3
2390,93353,2020-11-26,100,20,87,11,1,Burgenland,120,31,64.5
2391,142139,2020-11-26,370,36,74,24,2,Kärnten,406,60,60.0
2392,509572,2020-11-26,536,112,484,88,3,Niederösterreich,648,200,56.0
2393,390016,2020-11-26,873,149,327,9,4,Oberösterreich,1022,158,94.3
2394,174968,2020-11-26,222,27,96,22,5,Salzburg,249,49,55.1
2395,315361,2020-11-26,617,114,377,41,6,Steiermark,731,155,73.5
2396,394934,2020-11-26,350,70,127,12,7,Tirol,420,82,85.4
2397,165778,2020-11-26,135,36,297,25,8,Vorarlberg,171,61,59.0
2398,807693,2020-11-26,553,141,1752,249,9,Wien,694,390,36.2
2399,2993814,2020-11-26,3756,705,3621,481,10,Alle,4461,1186,59.4
2400,94651,2020-11-27,91,20,99,11,1,Burgenland,111,31,64.5
2401,143881,2020-11-27,402,35,42,25,2,Kärnten,437,60,58.3
2402,515026,2020-11-27,507,111,513,80,3,Niederösterreich,618,191,58.1
2403,392760,2020-11-27,873,145,327,30,4,Oberösterreich,1018,175,82.9
2404,176579,2020-11-27,227,27,38,18,5,Salzburg,254,45,60.0
2405,318156,2020-11-27,609,122,386,36,6,Steiermark,731,158,77.2
2406,397563,2020-11-27,319,73,144,10,7,Tirol,392,83,88.0
2407,167724,2020-11-27,126,34,306,25,8,Vorarlberg,160,59,57.6
2408,814522,2020-11-27,548,136,1811,232,9,Wien,684,368,37.0
2409,3020862,2020-11-27,3702,703,3666,467,10,Alle,4405,1170,60.1
2410,95303,2020-11-28,81,22,102,9,1,Burgenland,103,31,71.0
2411,145222,2020-11-28,384,32,68,28,2,Kärnten,416,60,53.3
2412,520313,2020-11-28,492,106,528,88,3,Niederösterreich,598,194,54.6
2413,407397,2020-11-28,843,148,357,38,4,Oberösterreich,991,186,79.6
2414,178471,2020-11-28,235,26,33,19,5,Salzburg,261,45,57.8
2415,320774,2020-11-28,604,121,395,35,6,Steiermark,725,156,77.6
2416,400339,2020-11-28,307,70,139,10,7,Tirol,377,80,87.5
2417,169858,2020-11-28,118,30,314,26,8,Vorarlberg,148,56,53.6
2418,823390,2020-11-28,527,133,1890,252,9,Wien,660,385,34.5
2419,3061067,2020-11-28,3591,688,3826,505,10,Alle,4279,1193,57.7
2420,95965,2020-11-29,76,21,104,10,1,Burgenland,97,31,67.7
2421,146807,2020-11-29,385,34,59,26,2,Kärnten,419,60,56.7
2422,527200,2020-11-29,462,103,558,96,3,Niederösterreich,565,199,51.8
2423,408365,2020-11-29,866,146,334,40,4,Oberösterreich,1012,186,78.5
2424,179864,2020-11-29,222,24,74,21,5,Salzburg,246,45,53.3
2425,323543,2020-11-29,603,127,396,30,6,Steiermark,730,157,80.9
2426,402018,2020-11-29,307,71,146,11,7,Tirol,378,82,86.6
2427,171826,2020-11-29,121,31,311,26,8,Vorarlberg,152,57,54.4
2428,827676,2020-11-29,518,134,1951,253,9,Wien,652,387,34.6
2429,3083264,2020-11-29,3560,691,3933,513,10,Alle,4251,1204,57.4
2430,96565,2020-11-30,84,22,104,9,1,Burgenland,106,31,71.0
2431,148739,2020-11-30,391,35,58,25,2,Kärnten,426,60,58.3
2432,531533,2020-11-30,482,105,538,101,3,Niederösterreich,587,206,51.0
2433,410155,2020-11-30,884,151,316,35,4,Oberösterreich,1035,186,81.2
2434,180756,2020-11-30,211,25,85,20,5,Salzburg,236,45,55.6
2435,324319,2020-11-30,608,123,389,34,6,Steiermark,731,157,78.3
2436,403494,2020-11-30,316,72,151,11,7,Tirol,388,83,86.7
2437,172613,2020-11-30,131,32,301,28,8,Vorarlberg,163,60,53.3
2438,830144,2020-11-30,532,136,1919,249,9,Wien,668,385,35.3
2439,3098318,2020-11-30,3639,701,3861,512,10,Alle,4340,1213,57.8
2440,96851,2020-12-01,87,20,99,11,1,Burgenland,107,31,64.5
2441,149763,2020-12-01,382,33,67,27,2,Kärnten,415,60,55.0
2442,536908,2020-12-01,506,99,514,113,3,Niederösterreich,605,212,46.7
2443,412228,2020-12-01,852,152,348,34,4,Oberösterreich,1004,186,81.7
2444,182045,2020-12-01,295,28,1,17,5,Salzburg,323,45,62.2
2445,327052,2020-12-01,642,124,359,35,6,Steiermark,766,159,78.0
2446,405935,2020-12-01,333,75,136,10,7,Tirol,408,85,88.2
2447,173500,2020-12-01,131,32,309,32,8,Vorarlberg,163,64,50.0
2448,837228,2020-12-01,563,128,2024,256,9,Wien,691,384,33.3
2449,3121510,2020-12-01,3791,691,3857,535,10,Alle,4482,1226,56.4
2450,97629,2020-12-02,84,19,100,7,1,Burgenland,103,26,73.1
2451,150775,2020-12-02,377,35,75,25,2,Kärnten,412,60,58.3
2452,540949,2020-12-02,484,101,536,98,3,Niederösterreich,585,199,50.8
2453,416203,2020-12-02,786,151,414,35,4,Oberösterreich,937,186,81.2
2454,183930,2020-12-02,197,24,71,21,5,Salzburg,221,45,53.3
2455,330337,2020-12-02,632,110,369,48,6,Steiermark,742,158,69.6
2456,408193,2020-12-02,328,74,114,10,7,Tirol,402,84,88.1
2457,175570,2020-12-02,123,31,311,29,8,Vorarlberg,154,60,51.7
2458,845786,2020-12-02,560,129,1853,252,9,Wien,689,381,33.9
2459,3149372,2020-12-02,3571,674,3843,525,10,Alle,4245,1199,56.2
2460,98184,2020-12-03,81,18,103,8,1,Burgenland,99,26,69.2
2461,151875,2020-12-03,366,32,86,28,2,Kärnten,398,60,53.3
2462,548049,2020-12-03,463,98,557,98,3,Niederösterreich,561,196,50.0
2463,418972,2020-12-03,751,144,449,42,4,Oberösterreich,895,186,77.4
2464,186147,2020-12-03,193,24,75,21,5,Salzburg,217,45,53.3
2465,333357,2020-12-03,590,112,412,47,6,Steiermark,702,159,70.4
2466,411394,2020-12-03,296,81,129,5,7,Tirol,377,86,94.2
2467,178067,2020-12-03,121,31,315,32,8,Vorarlberg,152,63,49.2
2468,854621,2020-12-03,553,128,1830,270,9,Wien,681,398,32.2
2469,3180666,2020-12-03,3414,668,3956,551,10,Alle,4082,1219,54.8
2470,98821,2020-12-04,78,19,108,12,1,Burgenland,97,31,61.3
2471,152813,2020-12-04,361,32,91,28,2,Kärnten,393,60,53.3
2472,555053,2020-12-04,450,95,570,117,3,Niederösterreich,545,212,44.8
2473,421586,2020-12-04,736,142,464,44,4,Oberösterreich,878,186,76.3
2474,187810,2020-12-04,190,24,78,21,5,Salzburg,214,45,53.3
2475,336536,2020-12-04,574,104,426,54,6,Steiermark,678,158,65.8
2476,413610,2020-12-04,295,76,118,10,7,Tirol,371,86,88.4
2477,180246,2020-12-04,117,29,318,35,8,Vorarlberg,146,64,45.3
2478,862865,2020-12-04,537,121,1789,257,9,Wien,658,378,32.0
2479,3209340,2020-12-04,3338,642,3962,578,10,Alle,3980,1220,52.6
2480,100920,2020-12-05,75,16,112,13,1,Burgenland,91,29,55.2
2481,153560,2020-12-05,360,29,92,31,2,Kärnten,389,60,48.3
2482,561918,2020-12-05,452,94,568,123,3,Niederösterreich,546,217,43.3
2483,413527,2020-12-05,687,140,513,46,4,Oberösterreich,827,186,75.3
2484,188630,2020-12-05,184,26,84,19,5,Salzburg,210,45,57.8
2485,340175,2020-12-05,551,117,449,42,6,Steiermark,668,159,73.6
2486,416176,2020-12-05,279,74,116,8,7,Tirol,353,82,90.2
2487,182391,2020-12-05,114,26,324,38,8,Vorarlberg,140,64,40.6
2488,872096,2020-12-05,529,124,1916,200,9,Wien,653,324,38.3
2489,3229393,2020-12-05,3231,646,4174,520,10,Alle,3877,1166,55.4
2490,101476,2020-12-06,77,14,108,17,1,Burgenland,91,31,45.2
2491,154231,2020-12-06,368,29,84,31,2,Kärnten,397,60,48.3
2492,567834,2020-12-06,436,91,584,114,3,Niederösterreich,527,205,44.4
2493,415271,2020-12-06,715,139,485,47,4,Oberösterreich,854,186,74.7
2494,189162,2020-12-06,183,29,85,16,5,Salzburg,212,45,64.4
2495,341498,2020-12-06,522,102,445,47,6,Steiermark,624,149,68.5
2496,417848,2020-12-06,261,68,112,14,7,Tirol,329,82,82.9
2497,184325,2020-12-06,108,24,327,38,8,Vorarlberg,132,62,38.7
2498,875866,2020-12-06,500,136,2003,218,9,Wien,636,354,38.4
2499,3247511,2020-12-06,3170,632,4233,542,10,Alle,3802,1174,53.8
2500,101961,2020-12-07,68,14,114,16,1,Burgenland,82,30,46.7
2501,154760,2020-12-07,362,31,90,29,2,Kärnten,393,60,51.7
2502,572976,2020-12-07,440,84,580,132,3,Niederösterreich,524,216,38.9
2503,416585,2020-12-07,753,141,447,45,4,Oberösterreich,894,186,75.8
2504,190151,2020-12-07,190,28,78,17,5,Salzburg,218,45,62.2
2505,343227,2020-12-07,561,102,438,55,6,Steiermark,663,157,65.0
2506,419046,2020-12-07,268,67,106,14,7,Tirol,335,81,82.7
2507,185295,2020-12-07,105,25,325,41,8,Vorarlberg,130,66,37.9
2508,878087,2020-12-07,522,124,2007,202,9,Wien,646,326,38.0
2509,3262088,2020-12-07,3269,616,4185,551,10,Alle,3885,1167,52.8
2510,102250,2020-12-08,65,14,117,15,1,Burgenland,79,29,48.3
2511,155727,2020-12-08,355,26,97,34,2,Kärnten,381,60,43.3
2512,574977,2020-12-08,454,86,566,139,3,Niederösterreich,540,225,38.2
2513,419626,2020-12-08,724,134,476,52,4,Oberösterreich,858,186,72.0
2514,191011,2020-12-08,203,30,63,15,5,Salzburg,233,45,66.7
2515,345295,2020-12-08,562,101,439,56,6,Steiermark,663,157,64.3
2516,421501,2020-12-08,282,69,90,14,7,Tirol,351,83,83.1
2517,186042,2020-12-08,107,22,332,37,8,Vorarlberg,129,59,37.3
2518,885302,2020-12-08,556,127,2011,199,9,Wien,683,326,39.0
2519,3281731,2020-12-08,3308,609,4191,561,10,Alle,3917,1170,52.1
2520,102945,2020-12-09,62,11,121,16,1,Burgenland,73,27,40.7
2521,156314,2020-12-09,359,27,93,33,2,Kärnten,386,60,45.0
2522,578424,2020-12-09,419,92,601,136,3,Niederösterreich,511,228,40.4
2523,421267,2020-12-09,737,133,463,53,4,Oberösterreich,870,186,71.5
2524,192302,2020-12-09,198,28,70,17,5,Salzburg,226,45,62.2
2525,346691,2020-12-09,581,99,422,58,6,Steiermark,680,157,63.1
2526,422902,2020-12-09,256,67,111,15,7,Tirol,323,82,81.7
2527,188252,2020-12-09,100,23,337,40,8,Vorarlberg,123,63,36.5
2528,892985,2020-12-09,532,130,1939,200,9,Wien,662,330,39.4
2529,3302082,2020-12-09,3244,610,4157,568,10,Alle,3854,1178,51.8
2530,103863,2020-12-10,69,8,120,16,1,Burgenland,77,24,33.3
2531,157266,2020-12-10,359,26,93,34,2,Kärnten,385,60,43.3
2532,584627,2020-12-10,419,87,601,132,3,Niederösterreich,506,219,39.7
2533,423592,2020-12-10,674,123,526,34,4,Oberösterreich,797,157,78.3
2534,194038,2020-12-10,202,27,66,18,5,Salzburg,229,45,60.0
2535,349915,2020-12-10,581,95,420,61,6,Steiermark,676,156,60.9
2536,424656,2020-12-10,260,66,108,15,7,Tirol,326,81,81.5
2537,189180,2020-12-10,95,24,331,20,8,Vorarlberg,119,44,54.5
2538,902860,2020-12-10,536,129,1836,203,9,Wien,665,332,38.9
2539,3329997,2020-12-10,3195,585,4101,533,10,Alle,3780,1118,52.3
2540,104238,2020-12-11,69,9,118,15,1,Burgenland,78,24,37.5
2541,158016,2020-12-11,339,30,113,30,2,Kärnten,369,60,50.0
2542,587898,2020-12-11,412,82,608,114,3,Niederösterreich,494,196,41.8
2543,425985,2020-12-11,636,124,564,33,4,Oberösterreich,760,157,79.0
2544,194856,2020-12-11,209,25,59,20,5,Salzburg,234,45,55.6
2545,352924,2020-12-11,549,94,435,62,6,Steiermark,643,156,60.3
2546,427037,2020-12-11,233,56,127,19,7,Tirol,289,75,74.7
2547,191404,2020-12-11,101,25,333,23,8,Vorarlberg,126,48,52.1
2548,913033,2020-12-11,531,127,1733,186,9,Wien,658,313,40.6
2549,3355391,2020-12-11,3079,572,4090,502,10,Alle,3651,1074,53.3
2550,104871,2020-12-12,58,13,127,10,1,Burgenland,71,23,56.5
2551,158716,2020-12-12,333,27,119,33,2,Kärnten,360,60,45.0
2552,597620,2020-12-12,388,83,632,122,3,Niederösterreich,471,205,40.5
2553,428085,2020-12-12,620,124,580,33,4,Oberösterreich,744,157,79.0
2554,196277,2020-12-12,199,26,69,19,5,Salzburg,225,45,57.8
2555,355296,2020-12-12,548,94,436,60,6,Steiermark,642,154,61.0
2556,429030,2020-12-12,239,61,134,12,7,Tirol,300,73,83.6
2557,193227,2020-12-12,99,25,344,22,8,Vorarlberg,124,47,53.2
2558,923186,2020-12-12,524,138,2020,184,9,Wien,662,322,42.9
2559,3386308,2020-12-12,3008,591,4461,495,10,Alle,3599,1086,54.4
2560,105306,2020-12-13,54,11,137,13,1,Burgenland,65,24,45.8
2561,159242,2020-12-13,319,26,133,34,2,Kärnten,345,60,43.3
2562,605067,2020-12-13,372,82,648,115,3,Niederösterreich,454,197,41.6
2563,429811,2020-12-13,641,121,559,36,4,Oberösterreich,762,157,77.1
2564,197104,2020-12-13,181,25,87,20,5,Salzburg,206,45,55.6
2565,356399,2020-12-13,511,93,473,61,6,Steiermark,604,154,60.4
2566,430280,2020-12-13,213,57,142,14,7,Tirol,270,71,80.3
2567,194759,2020-12-13,88,21,344,22,8,Vorarlberg,109,43,48.8
2568,929542,2020-12-13,488,141,1982,190,9,Wien,629,331,42.6
2569,3407510,2020-12-13,2867,577,4505,505,10,Alle,3444,1082,53.3
2570,105684,2020-12-14,55,13,133,11,1,Burgenland,68,24,54.2
2571,161056,2020-12-14,321,27,131,33,2,Kärnten,348,60,45.0
2572,610387,2020-12-14,397,87,648,120,3,Niederösterreich,484,207,42.0
2573,431325,2020-12-14,644,122,556,35,4,Oberösterreich,766,157,77.7
2574,198229,2020-12-14,176,26,92,19,5,Salzburg,202,45,57.8
2575,357976,2020-12-14,494,95,488,61,6,Steiermark,589,156,60.9
2576,431328,2020-12-14,217,57,135,15,7,Tirol,274,72,79.2
2577,195759,2020-12-14,88,22,343,24,8,Vorarlberg,110,46,47.8
2578,933328,2020-12-14,493,145,2083,201,9,Wien,638,346,41.9
2579,3425072,2020-12-14,2885,594,4609,519,10,Alle,3479,1113,53.4
2580,105917,2020-12-15,58,13,129,10,1,Burgenland,71,23,56.5
2581,161917,2020-12-15,323,23,129,37,2,Kärnten,346,60,38.3
2582,613771,2020-12-15,417,82,603,115,3,Niederösterreich,499,197,41.6
2583,433407,2020-12-15,624,114,576,43,4,Oberösterreich,738,157,72.6
2584,200068,2020-12-15,174,27,94,18,5,Salzburg,201,45,60.0
2585,359589,2020-12-15,509,97,458,58,6,Steiermark,606,155,62.6
2586,433595,2020-12-15,214,60,81,15,7,Tirol,274,75,80.0
2587,196605,2020-12-15,108,18,342,23,8,Vorarlberg,126,41,43.9
2588,941240,2020-12-15,524,139,1911,184,9,Wien,663,323,43.0
2589,3446109,2020-12-15,2951,573,4323,503,10,Alle,3524,1076,53.3
2590,107108,2020-12-16,60,12,124,11,1,Burgenland,72,23,52.2
2591,162900,2020-12-16,298,29,154,31,2,Kärnten,327,60,48.3
2592,617321,2020-12-16,397,82,623,114,3,Niederösterreich,479,196,41.8
2593,435420,2020-12-16,607,114,593,43,4,Oberösterreich,721,157,72.6
2594,201590,2020-12-16,168,25,100,20,5,Salzburg,193,45,55.6
2595,364050,2020-12-16,511,88,467,66,6,Steiermark,599,154,57.1
2596,435890,2020-12-16,213,54,82,15,7,Tirol,267,69,78.3
2597,198544,2020-12-16,102,17,347,24,8,Vorarlberg,119,41,41.5
2598,952033,2020-12-16,506,127,1731,184,9,Wien,633,311,40.8
2599,3474856,2020-12-16,2862,548,4221,508,10,Alle,3410,1056,51.9
2600,107601,2020-12-17,65,8,119,15,1,Burgenland,73,23,34.8
2601,163703,2020-12-17,264,22,188,38,2,Kärnten,286,60,36.7
2602,623657,2020-12-17,351,82,669,111,3,Niederösterreich,433,193,42.5
2603,437830,2020-12-17,575,108,625,49,4,Oberösterreich,683,157,68.8
2604,202940,2020-12-17,168,28,101,17,5,Salzburg,196,45,62.2
2605,365910,2020-12-17,495,83,479,72,6,Steiermark,578,155,53.5
2606,437978,2020-12-17,195,55,92,13,7,Tirol,250,68,80.9
2607,200388,2020-12-17,104,19,347,23,8,Vorarlberg,123,42,45.2
2608,963065,2020-12-17,473,125,1669,174,9,Wien,598,299,41.8
2609,3503072,2020-12-17,2690,530,4289,512,10,Alle,3220,1042,50.9
2610,108235,2020-12-18,62,8,121,16,1,Burgenland,70,24,33.3
2611,165592,2020-12-18,252,19,200,41,2,Kärnten,271,60,31.7
2612,631051,2020-12-18,344,74,676,111,3,Niederösterreich,418,185,40.0
2613,439764,2020-12-18,554,103,646,54,4,Oberösterreich,657,157,65.6
2614,204187,2020-12-18,160,27,110,18,5,Salzburg,187,45,60.0
2615,368662,2020-12-18,455,76,522,78,6,Steiermark,531,154,49.4
2616,439776,2020-12-18,184,51,93,16,7,Tirol,235,67,76.1
2617,202797,2020-12-18,97,18,353,30,8,Vorarlberg,115,48,37.5
2618,974422,2020-12-18,470,119,1704,177,9,Wien,589,296,40.2
2619,3534486,2020-12-18,2578,495,4425,541,10,Alle,3073,1036,47.8
2620,108612,2020-12-19,70,8,119,15,1,Burgenland,78,23,34.8
2621,166218,2020-12-19,247,15,205,45,2,Kärnten,262,60,25.0
2622,639563,2020-12-19,340,65,680,102,3,Niederösterreich,405,167,38.9
2623,441828,2020-12-19,530,100,670,57,4,Oberösterreich,630,157,63.7
2624,205286,2020-12-19,143,30,125,15,5,Salzburg,173,45,66.7
2625,371778,2020-12-19,436,78,541,76,6,Steiermark,514,154,50.6
2626,441800,2020-12-19,192,50,104,16,7,Tirol,242,66,75.8
2627,205408,2020-12-19,70,18,362,28,8,Vorarlberg,88,46,39.1
2628,987793,2020-12-19,447,125,1888,185,9,Wien,572,310,40.3
2629,3568286,2020-12-19,2475,489,4694,539,10,Alle,2964,1028,47.6
2630,108793,2020-12-20,62,8,125,14,1,Burgenland,70,22,36.4
2631,166640,2020-12-20,245,13,207,47,2,Kärnten,258,60,21.7
2632,646063,2020-12-20,330,64,690,106,3,Niederösterreich,394,170,37.6
2633,443093,2020-12-20,554,95,646,62,4,Oberösterreich,649,157,60.5
2634,205955,2020-12-20,137,30,118,15,5,Salzburg,167,45,66.7
2635,373172,2020-12-20,409,81,570,74,6,Steiermark,490,155,52.3
2636,442910,2020-12-20,166,51,118,18,7,Tirol,217,69,73.9
2637,208112,2020-12-20,67,17,365,32,8,Vorarlberg,84,49,34.7
2638,998538,2020-12-20,442,116,2080,185,9,Wien,558,301,38.5
2639,3593276,2020-12-20,2412,475,4919,553,10,Alle,2887,1028,46.2
2640,109198,2020-12-21,53,9,135,15,1,Burgenland,62,24,37.5
2641,167107,2020-12-21,240,16,212,44,2,Kärnten,256,60,26.7
2642,652173,2020-12-21,328,69,692,132,3,Niederösterreich,397,201,34.3
2643,444317,2020-12-21,556,93,634,64,4,Oberösterreich,649,157,59.2
2644,206529,2020-12-21,133,30,122,15,5,Salzburg,163,45,66.7
2645,374006,2020-12-21,418,79,561,74,6,Steiermark,497,153,51.6
2646,443879,2020-12-21,165,49,125,20,7,Tirol,214,69,71.0
2647,209439,2020-12-21,70,16,362,31,8,Vorarlberg,86,47,34.0
2648,1007585,2020-12-21,430,117,2010,185,9,Wien,547,302,38.7
2649,3614233,2020-12-21,2393,478,4853,580,10,Alle,2871,1058,45.2
2650,110218,2020-12-22,54,9,134,16,1,Burgenland,63,25,36.0
2651,167788,2020-12-22,206,15,246,45,2,Kärnten,221,60,25.0
2652,654618,2020-12-22,364,67,656,134,3,Niederösterreich,431,201,33.3
2653,446485,2020-12-22,554,95,646,62,4,Oberösterreich,649,157,60.5
2654,207888,2020-12-22,133,30,113,15,5,Salzburg,163,45,66.7
2655,377261,2020-12-22,434,84,543,71,6,Steiermark,518,155,54.2
2656,445765,2020-12-22,171,51,116,19,7,Tirol,222,70,72.9
2657,210559,2020-12-22,70,16,366,30,8,Vorarlberg,86,46,34.8
2658,1023114,2020-12-22,449,120,1938,194,9,Wien,569,314,38.2
2659,3643696,2020-12-22,2435,487,4758,586,10,Alle,2922,1073,45.4
2660,110392,2020-12-23,49,8,137,16,1,Burgenland,57,24,33.3
2661,168568,2020-12-23,176,13,276,47,2,Kärnten,189,60,21.7
2662,657388,2020-12-23,359,60,661,122,3,Niederösterreich,419,182,33.0
2663,448758,2020-12-23,543,96,657,31,4,Oberösterreich,639,127,75.6
2664,209310,2020-12-23,131,30,117,15,5,Salzburg,161,45,66.7
2665,380075,2020-12-23,409,90,568,64,6,Steiermark,499,154,58.4
2666,448003,2020-12-23,133,48,143,22,7,Tirol,181,70,68.6
2667,214278,2020-12-23,66,16,143,25,8,Vorarlberg,82,41,39.0
2668,1045364,2020-12-23,437,111,2087,204,9,Wien,548,315,35.2
2669,3682136,2020-12-23,2303,472,4789,546,10,Alle,2775,1018,46.4
2670,110907,2020-12-24,45,10,139,18,1,Burgenland,55,28,35.7
2671,169184,2020-12-24,163,13,289,47,2,Kärnten,176,60,21.7
2672,663988,2020-12-24,353,61,667,113,3,Niederösterreich,414,174,35.1
2673,451056,2020-12-24,521,81,679,46,4,Oberösterreich,602,127,63.8
2674,210915,2020-12-24,119,32,102,8,5,Salzburg,151,40,80.0
2675,382568,2020-12-24,390,85,588,68,6,Steiermark,475,153,55.6
2676,450504,2020-12-24,133,42,145,25,7,Tirol,175,67,62.7
2677,218317,2020-12-24,62,15,150,25,8,Vorarlberg,77,40,37.5
2678,1053848,2020-12-24,417,106,2409,219,9,Wien,523,325,32.6
2679,3711287,2020-12-24,2203,445,5168,569,10,Alle,2648,1014,43.9
2680,111372,2020-12-25,32,10,145,17,1,Burgenland,42,27,37.0
2681,169264,2020-12-25,152,13,300,47,2,Kärnten,165,60,21.7
2682,669959,2020-12-25,343,55,677,134,3,Niederösterreich,398,189,29.1
2683,452223,2020-12-25,491,82,709,45,4,Oberösterreich,573,127,64.6
2684,211478,2020-12-25,125,28,102,12,5,Salzburg,153,40,70.0
2685,384322,2020-12-25,342,78,636,76,6,Steiermark,420,154,50.6
2686,451535,2020-12-25,110,44,163,23,7,Tirol,154,67,65.7
2687,224427,2020-12-25,55,13,155,28,8,Vorarlberg,68,41,31.7
2688,1058323,2020-12-25,395,86,2723,221,9,Wien,481,307,28.0
2689,3732903,2020-12-25,2045,409,5610,603,10,Alle,2454,1012,40.4
2690,111720,2020-12-26,30,8,151,20,1,Burgenland,38,28,28.6
2691,169518,2020-12-26,160,13,292,47,2,Kärnten,173,60,21.7
2692,677976,2020-12-26,336,55,684,154,3,Niederösterreich,391,209,26.3
2693,453200,2020-12-26,497,83,703,44,4,Oberösterreich,580,127,65.4
2694,212125,2020-12-26,125,31,106,9,5,Salzburg,156,40,77.5
2695,384707,2020-12-26,327,79,651,75,6,Steiermark,406,154,51.3
2696,452006,2020-12-26,110,43,163,23,7,Tirol,153,66,65.2
2697,226736,2020-12-26,50,12,156,28,8,Vorarlberg,62,40,30.0
2698,1059340,2020-12-26,389,107,2659,237,9,Wien,496,344,31.1
2699,3747328,2020-12-26,2024,431,5565,637,10,Alle,2455,1068,40.4
2700,112127,2020-12-27,30,8,153,19,1,Burgenland,38,27,29.6
2701,169672,2020-12-27,155,14,297,46,2,Kärnten,169,60,23.3
2702,682026,2020-12-27,321,51,699,153,3,Niederösterreich,372,204,25.0
2703,454084,2020-12-27,525,75,675,52,4,Oberösterreich,600,127,59.1
2704,212779,2020-12-27,129,28,103,17,5,Salzburg,157,45,62.2
2705,385368,2020-12-27,330,78,650,73,6,Steiermark,408,151,51.7
2706,452970,2020-12-27,109,43,164,23,7,Tirol,152,66,65.2
2707,227623,2020-12-27,49,12,156,27,8,Vorarlberg,61,39,30.8
2708,1060588,2020-12-27,395,105,2532,225,9,Wien,500,330,31.8
2709,3757237,2020-12-27,2043,414,5429,635,10,Alle,2457,1049,39.5
2710,112295,2020-12-28,29,10,150,17,1,Burgenland,39,27,37.0
2711,171045,2020-12-28,154,17,298,43,2,Kärnten,171,60,28.3
2712,686237,2020-12-28,328,55,692,151,3,Niederösterreich,383,206,26.7
2713,457404,2020-12-28,539,76,661,51,4,Oberösterreich,615,127,59.8
2714,213656,2020-12-28,139,28,93,17,5,Salzburg,167,45,62.2
2715,387139,2020-12-28,340,73,640,78,6,Steiermark,413,151,48.3
2716,453845,2020-12-28,113,41,157,23,7,Tirol,154,64,64.1
2717,228840,2020-12-28,49,13,153,23,8,Vorarlberg,62,36,36.1
2718,1068022,2020-12-28,398,108,2440,216,9,Wien,506,324,33.3
2719,3778483,2020-12-28,2089,421,5284,619,10,Alle,2510,1040,40.5
2720,113470,2020-12-29,31,11,149,14,1,Burgenland,42,25,44.0
2721,171708,2020-12-29,136,16,316,44,2,Kärnten,152,60,26.7
2722,689212,2020-12-29,346,53,674,152,3,Niederösterreich,399,205,25.9
2723,460040,2020-12-29,526,70,674,57,4,Oberösterreich,596,127,55.1
2724,214905,2020-12-29,137,28,95,17,5,Salzburg,165,45,62.2
2725,388755,2020-12-29,351,71,629,80,6,Steiermark,422,151,47.0
2726,455731,2020-12-29,110,40,158,24,7,Tirol,150,64,62.5
2727,229799,2020-12-29,52,14,156,31,8,Vorarlberg,66,45,31.1
2728,1070426,2020-12-29,427,108,2418,203,9,Wien,535,311,34.7
2729,3794046,2020-12-29,2116,411,5269,622,10,Alle,2527,1033,39.8
2730,113766,2020-12-30,30,9,150,15,1,Burgenland,39,24,37.5
2731,172129,2020-12-30,143,12,309,48,2,Kärnten,155,60,20.0
2732,692455,2020-12-30,329,53,691,130,3,Niederösterreich,382,183,29.0
2733,463101,2020-12-30,485,71,715,32,4,Oberösterreich,556,103,68.9
2734,216445,2020-12-30,141,27,91,18,5,Salzburg,168,45,60.0
2735,391379,2020-12-30,345,67,636,83,6,Steiermark,412,150,44.7
2736,457920,2020-12-30,102,36,148,24,7,Tirol,138,60,60.0
2737,232510,2020-12-30,49,13,156,26,8,Vorarlberg,62,39,33.3
2738,1070426,2020-12-30,388,107,2175,201,9,Wien,495,308,34.7
2739,3810131,2020-12-30,2012,395,5071,577,10,Alle,2407,972,40.6
2740,114729,2020-12-31,33,10,143,14,1,Burgenland,43,24,41.7
2741,172784,2020-12-31,134,12,318,48,2,Kärnten,146,60,20.0
2742,698629,2020-12-31,329,55,691,112,3,Niederösterreich,384,167,32.9
2743,465906,2020-12-31,461,74,739,29,4,Oberösterreich,535,103,71.8
2744,217713,2020-12-31,124,24,108,21,5,Salzburg,148,45,53.3
2745,393234,2020-12-31,322,65,657,85,6,Steiermark,387,150,43.3
2746,459639,2020-12-31,102,36,146,25,7,Tirol,138,61,59.0
2747,235292,2020-12-31,49,16,158,25,8,Vorarlberg,65,41,39.0
2748,1078994,2020-12-31,392,104,2262,210,9,Wien,496,314,33.1
2749,3836920,2020-12-31,1946,396,5222,569,10,Alle,2342,965,41.0
2750,115045,2021-01-01,35,7,144,18,1,Burgenland,42,25,28.0
2751,173185,2021-01-01,114,13,338,47,2,Kärnten,127,60,21.7
2752,704329,2021-01-01,324,49,696,134,3,Niederösterreich,373,183,26.8
2753,468813,2021-01-01,434,73,766,30,4,Oberösterreich,507,103,70.9
2754,218627,2021-01-01,126,20,106,25,5,Salzburg,146,45,44.4
2755,396082,2021-01-01,318,65,662,85,6,Steiermark,383,150,43.3
2756,460462,2021-01-01,94,34,152,21,7,Tirol,128,55,61.8
2757,237960,2021-01-01,47,17,159,31,8,Vorarlberg,64,48,35.4
2758,1082879,2021-01-01,366,107,3021,224,9,Wien,473,331,32.3
2759,3857382,2021-01-01,1858,385,6044,615,10,Alle,2243,1000,38.5
2760,115045,2021-01-02,35,7,144,18,1,Burgenland,42,25,28.0
2761,173185,2021-01-02,114,13,338,47,2,Kärnten,127,60,21.7
2762,704329,2021-01-02,324,49,696,134,3,Niederösterreich,373,183,26.8
2763,468813,2021-01-02,434,73,766,30,4,Oberösterreich,507,103,70.9
2764,218627,2021-01-02,126,20,106,25,5,Salzburg,146,45,44.4
2765,396082,2021-01-02,318,65,662,85,6,Steiermark,383,150,43.3
2766,460462,2021-01-02,94,34,152,21,7,Tirol,128,55,61.8
2767,237960,2021-01-02,47,17,159,31,8,Vorarlberg,64,48,35.4
2768,1082879,2021-01-02,366,107,3021,224,9,Wien,473,331,32.3
2769,3857382,2021-01-02,1858,385,6044,615,10,Alle,2243,1000,38.5
2770,116027,2021-01-03,33,5,143,21,1,Burgenland,38,26,19.2
2771,173977,2021-01-03,114,13,338,47,2,Kärnten,127,60,21.7
2772,717323,2021-01-03,366,51,654,155,3,Niederösterreich,417,206,24.8
2773,473337,2021-01-03,433,72,767,31,4,Oberösterreich,505,103,69.9
2774,219906,2021-01-03,124,21,111,22,5,Salzburg,145,43,48.8
2775,397518,2021-01-03,299,65,681,86,6,Steiermark,364,151,43.0
2776,462360,2021-01-03,97,31,133,25,7,Tirol,128,56,55.4
2777,240835,2021-01-03,44,13,153,32,8,Vorarlberg,57,45,28.9
2778,979206,2021-01-03,354,92,2607,216,9,Wien,446,308,29.9
2779,3780489,2021-01-03,1864,363,5587,635,10,Alle,2227,998,36.4
2780,116381,2021-01-04,32,5,144,21,1,Burgenland,37,26,19.2
2781,175424,2021-01-04,120,15,332,45,2,Kärnten,135,60,25.0
2782,722228,2021-01-04,375,47,645,160,3,Niederösterreich,422,207,22.7
2783,474508,2021-01-04,453,72,747,31,4,Oberösterreich,525,103,69.9
2784,220667,2021-01-04,117,22,117,23,5,Salzburg,139,45,48.9
2785,399394,2021-01-04,314,61,666,91,6,Steiermark,375,152,40.1
2786,463166,2021-01-04,110,33,128,21,7,Tirol,143,54,61.1
2787,241759,2021-01-04,52,11,146,33,8,Vorarlberg,63,44,25.0
2788,979563,2021-01-04,380,102,2536,206,9,Wien,482,308,33.1
2789,3793090,2021-01-04,1953,368,5461,631,10,Alle,2321,999,36.8
2790,116831,2021-01-05,39,5,141,19,1,Burgenland,44,24,20.8
2791,175979,2021-01-05,123,13,329,47,2,Kärnten,136,60,21.7
2792,724823,2021-01-05,397,49,623,146,3,Niederösterreich,446,195,25.1
2793,476011,2021-01-05,438,68,762,35,4,Oberösterreich,506,103,66.0
2794,221884,2021-01-05,125,21,107,24,5,Salzburg,146,45,46.7
2795,401663,2021-01-05,333,62,647,90,6,Steiermark,395,152,40.8
2796,464568,2021-01-05,122,33,131,23,7,Tirol,155,56,58.9
2797,243080,2021-01-05,58,11,147,32,8,Vorarlberg,69,43,25.6
2798,983701,2021-01-05,398,109,2312,214,9,Wien,507,323,33.7
2799,3808540,2021-01-05,2033,371,5199,630,10,Alle,2404,1001,37.1
2800,117204,2021-01-06,42,6,133,14,1,Burgenland,48,20,30.0
2801,176672,2021-01-06,119,13,333,47,2,Kärnten,132,60,21.7
2802,727993,2021-01-06,406,52,614,121,3,Niederösterreich,458,173,30.1
2803,478014,2021-01-06,429,62,771,41,4,Oberösterreich,491,103,60.2
2804,222244,2021-01-06,127,22,105,23,5,Salzburg,149,45,48.9
2805,403411,2021-01-06,320,57,659,95,6,Steiermark,377,152,37.5
2806,467068,2021-01-06,118,31,133,23,7,Tirol,149,54,57.4
2807,245146,2021-01-06,57,12,148,27,8,Vorarlberg,69,39,30.8
2808,993418,2021-01-06,404,106,2298,210,9,Wien,510,316,33.5
2809,3831170,2021-01-06,2022,361,5194,601,10,Alle,2383,962,37.5
2810,117825,2021-01-07,41,8,137,17,1,Burgenland,49,25,32.0
2811,177195,2021-01-07,123,12,329,48,2,Kärnten,135,60,20.0
2812,733493,2021-01-07,387,56,633,117,3,Niederösterreich,443,173,32.4
2813,479281,2021-01-07,422,58,328,45,4,Oberösterreich,480,103,56.3
2814,224289,2021-01-07,127,21,105,24,5,Salzburg,148,45,46.7
2815,405180,2021-01-07,303,63,676,89,6,Steiermark,366,152,41.4
2816,468213,2021-01-07,113,31,123,22,7,Tirol,144,53,58.5
2817,246233,2021-01-07,69,13,136,26,8,Vorarlberg,82,39,33.3
2818,996213,2021-01-07,396,111,2437,213,9,Wien,507,324,34.3
2819,3847922,2021-01-07,1981,373,4904,601,10,Alle,2354,974,38.3
2820,118226,2021-01-08,39,9,140,15,1,Burgenland,48,24,37.5
2821,177954,2021-01-08,129,12,323,48,2,Kärnten,141,60,20.0
2822,742564,2021-01-08,404,55,616,126,3,Niederösterreich,459,181,30.4
2823,480864,2021-01-08,402,60,348,43,4,Oberösterreich,462,103,58.3
2824,225771,2021-01-08,124,16,108,29,5,Salzburg,140,45,35.6
2825,407620,2021-01-08,306,65,652,90,6,Steiermark,371,155,41.9
2826,470159,2021-01-08,118,33,121,21,7,Tirol,151,54,61.1
2827,247237,2021-01-08,61,14,144,25,8,Vorarlberg,75,39,35.9
2828,1001132,2021-01-08,417,107,2244,208,9,Wien,524,315,34.0
2829,3871527,2021-01-08,2000,371,4696,605,10,Alle,2371,976,38.0
2830,118901,2021-01-09,42,7,138,19,1,Burgenland,49,26,26.9
2831,178387,2021-01-09,125,17,327,43,2,Kärnten,142,60,28.3
2832,748492,2021-01-09,388,57,632,121,3,Niederösterreich,445,178,32.0
2833,482469,2021-01-09,402,60,396,43,4,Oberösterreich,462,103,58.3
2834,226876,2021-01-09,120,18,113,27,5,Salzburg,138,45,40.0
2835,409590,2021-01-09,300,61,657,34,6,Steiermark,361,95,64.2
2836,471581,2021-01-09,118,28,119,26,7,Tirol,146,54,51.9
2837,248358,2021-01-09,59,15,146,27,8,Vorarlberg,74,42,35.7
2838,1006653,2021-01-09,403,106,2356,214,9,Wien,509,320,33.1
2839,3891307,2021-01-09,1957,369,4884,554,10,Alle,2326,923,40.0
2840,119246,2021-01-10,39,7,138,20,1,Burgenland,46,27,25.9
2841,178707,2021-01-10,136,16,316,44,2,Kärnten,152,60,26.7
2842,755960,2021-01-10,361,61,659,128,3,Niederösterreich,422,189,32.3
2843,483783,2021-01-10,379,62,371,41,4,Oberösterreich,441,103,60.2
2844,227482,2021-01-10,112,21,122,24,5,Salzburg,133,45,46.7
2845,410454,2021-01-10,272,51,705,98,6,Steiermark,323,149,34.2
2846,472479,2021-01-10,117,30,127,26,7,Tirol,147,56,53.6
2847,249228,2021-01-10,60,12,145,28,8,Vorarlberg,72,40,30.0
2848,1008143,2021-01-10,398,112,2451,192,9,Wien,510,304,36.8
2849,3905482,2021-01-10,1874,372,5034,601,10,Alle,2246,973,38.2
2850,119544,2021-01-11,33,7,139,18,1,Burgenland,40,25,28.0
2851,180380,2021-01-11,141,17,311,43,2,Kärnten,158,60,28.3
2852,763143,2021-01-11,379,62,641,140,3,Niederösterreich,441,202,30.7
2853,484917,2021-01-11,400,63,350,40,4,Oberösterreich,463,103,61.2
2854,228106,2021-01-11,111,21,121,24,5,Salzburg,132,45,46.7
2855,411086,2021-01-11,281,54,696,94,6,Steiermark,335,148,36.5
2856,473311,2021-01-11,119,30,127,26,7,Tirol,149,56,53.6
2857,250035,2021-01-11,68,12,137,28,8,Vorarlberg,80,40,30.0
2858,1009049,2021-01-11,386,113,2448,197,9,Wien,499,310,36.5
2859,3919571,2021-01-11,1918,379,4970,610,10,Alle,2297,989,38.3
2860,275208,2021-01-12,33,7,142,17,1,Burgenland,40,24,29.2
2861,296216,2021-01-12,117,19,335,41,2,Kärnten,136,60,31.7
2862,1438174,2021-01-12,390,59,630,130,3,Niederösterreich,449,189,31.2
2863,757238,2021-01-12,374,55,376,48,4,Oberösterreich,429,103,53.4
2864,418537,2021-01-12,116,19,116,26,5,Salzburg,135,45,42.2
2865,785761,2021-01-12,314,69,655,88,6,Steiermark,383,157,43.9
2866,830934,2021-01-12,126,30,121,31,7,Tirol,156,61,49.2
2867,449011,2021-01-12,68,12,144,28,8,Vorarlberg,80,40,30.0
2868,1614363,2021-01-12,385,108,2263,206,9,Wien,493,314,34.4
2869,6865442,2021-01-12,1923,378,4782,615,10,Alle,2301,993,38.1
2870,276473,2021-01-13,34,7,141,18,1,Burgenland,41,25,28.0
2871,297286,2021-01-13,107,15,345,45,2,Kärnten,122,60,25.0
2872,1493613,2021-01-13,400,55,620,125,3,Niederösterreich,455,180,30.6
2873,771841,2021-01-13,324,58,426,45,4,Oberösterreich,382,103,56.3
2874,419837,2021-01-13,113,15,119,30,5,Salzburg,128,45,33.3
2875,804761,2021-01-13,292,61,672,87,6,Steiermark,353,148,41.2
2876,840158,2021-01-13,124,27,122,28,7,Tirol,151,55,49.1
2877,452489,2021-01-13,61,11,149,27,8,Vorarlberg,72,38,28.9
2878,1633251,2021-01-13,370,105,2065,186,9,Wien,475,291,36.1
2879,6989709,2021-01-13,1825,354,4659,591,10,Alle,2179,945,37.5
2880,277590,2021-01-14,39,7,134,17,1,Burgenland,46,24,29.2
2881,298091,2021-01-14,92,13,360,47,2,Kärnten,105,60,21.7
2882,1503006,2021-01-14,376,56,644,116,3,Niederösterreich,432,172,32.6
2883,1109704,2021-01-14,312,57,438,46,4,Oberösterreich,369,103,55.3
2884,433123,2021-01-14,109,17,123,28,5,Salzburg,126,45,37.8
2885,806091,2021-01-14,285,59,669,90,6,Steiermark,344,149,39.6
2886,843027,2021-01-14,117,26,120,26,7,Tirol,143,52,50.0
2887,455590,2021-01-14,56,15,146,28,8,Vorarlberg,71,43,34.9
2888,1653751,2021-01-14,339,111,1802,196,9,Wien,450,307,36.2
2889,7379973,2021-01-14,1725,361,4436,594,10,Alle,2086,955,37.8
2890,278257,2021-01-15,43,6,106,17,1,Burgenland,49,23,26.1
2891,298951,2021-01-15,98,11,354,49,2,Kärnten,109,60,18.3
2892,1510727,2021-01-15,374,55,646,117,3,Niederösterreich,429,172,32.0
2893,1116743,2021-01-15,300,51,450,52,4,Oberösterreich,351,103,49.5
2894,434147,2021-01-15,113,17,119,28,5,Salzburg,130,45,37.8
2895,820834,2021-01-15,259,58,696,89,6,Steiermark,317,147,39.5
2896,846070,2021-01-15,114,26,122,20,7,Tirol,140,46,56.5
2897,461195,2021-01-15,59,14,151,24,8,Vorarlberg,73,38,36.8
2898,1692684,2021-01-15,345,99,1772,184,9,Wien,444,283,35.0
2899,7459608,2021-01-15,1705,337,4416,580,10,Alle,2042,917,36.8
2900,285688,2021-01-16,42,6,107,18,1,Burgenland,48,24,25.0
2901,299475,2021-01-16,100,12,352,48,2,Kärnten,112,60,20.0
2902,1517468,2021-01-16,371,56,649,112,3,Niederösterreich,427,168,33.3
2903,1121154,2021-01-16,292,52,458,51,4,Oberösterreich,344,103,50.5
2904,434955,2021-01-16,124,17,109,28,5,Salzburg,141,45,37.8
2905,828541,2021-01-16,239,61,716,88,6,Steiermark,300,149,40.9
2906,858048,2021-01-16,114,24,121,22,7,Tirol,138,46,52.2
2907,464165,2021-01-16,54,13,157,20,8,Vorarlberg,67,33,39.4
2908,1729238,2021-01-16,332,101,1865,196,9,Wien,433,297,34.0
2909,7538732,2021-01-16,1668,342,4534,583,10,Alle,2010,925,37.0
2910,286349,2021-01-17,47,6,129,12,1,Burgenland,53,18,33.3
2911,299957,2021-01-17,104,8,348,52,2,Kärnten,112,60,13.3
2912,1524009,2021-01-17,357,59,663,121,3,Niederösterreich,416,180,32.8
2913,1125890,2021-01-17,304,49,446,54,4,Oberösterreich,353,103,47.6
2914,435571,2021-01-17,124,16,111,29,5,Salzburg,140,45,35.6
2915,829431,2021-01-17,226,61,747,88,6,Steiermark,287,149,40.9
2916,864413,2021-01-17,108,24,124,23,7,Tirol,132,47,51.1
2917,466843,2021-01-17,48,12,157,26,8,Vorarlberg,60,38,31.6
2918,1758308,2021-01-17,317,93,2021,209,9,Wien,410,302,30.8
2919,7590771,2021-01-17,1635,328,4746,614,10,Alle,1963,942,34.8
2920,343641,2021-01-18,45,7,136,18,1,Burgenland,52,25,28.0
2921,302014,2021-01-18,120,8,332,52,2,Kärnten,128,60,13.3
2922,1530603,2021-01-18,365,57,655,146,3,Niederösterreich,422,203,28.1
2923,1129640,2021-01-18,308,48,442,55,4,Oberösterreich,356,103,46.6
2924,436212,2021-01-18,114,16,117,29,5,Salzburg,130,45,35.6
2925,829933,2021-01-18,225,63,751,86,6,Steiermark,288,149,42.3
2926,869960,2021-01-18,109,23,131,24,7,Tirol,132,47,48.9
2927,468719,2021-01-18,52,9,153,25,8,Vorarlberg,61,34,26.5
2928,1787040,2021-01-18,335,103,1994,182,9,Wien,438,285,36.1
2929,7697762,2021-01-18,1673,334,4711,617,10,Alle,2007,951,35.1
2930,346502,2021-01-19,47,8,135,13,1,Burgenland,55,21,38.1
2931,424344,2021-01-19,107,9,345,51,2,Kärnten,116,60,15.0
2932,1533092,2021-01-19,384,56,636,146,3,Niederösterreich,440,202,27.7
2933,1133696,2021-01-19,291,48,459,55,4,Oberösterreich,339,103,46.6
2934,441668,2021-01-19,116,19,116,26,5,Salzburg,135,45,42.2
2935,852248,2021-01-19,243,57,714,92,6,Steiermark,300,149,38.3
2936,874409,2021-01-19,127,24,114,23,7,Tirol,151,47,51.1
2937,472691,2021-01-19,52,9,159,23,8,Vorarlberg,61,32,28.1
2938,1800082,2021-01-19,362,102,1762,193,9,Wien,464,295,34.6
2939,7878732,2021-01-19,1729,332,4440,622,10,Alle,2061,954,34.8
2940,347780,2021-01-20,42,8,150,14,1,Burgenland,50,22,36.4
2941,426472,2021-01-20,113,12,339,48,2,Kärnten,125,60,20.0
2942,2079628,2021-01-20,373,54,647,140,3,Niederösterreich,427,194,27.8
2943,1151162,2021-01-20,268,43,482,60,4,Oberösterreich,311,103,41.7
2944,446595,2021-01-20,107,20,119,25,5,Salzburg,127,45,44.4
2945,861388,2021-01-20,239,52,717,94,6,Steiermark,291,146,35.6
2946,878194,2021-01-20,124,29,119,17,7,Tirol,153,46,63.0
2947,480022,2021-01-20,46,9,67,10,8,Vorarlberg,55,19,47.4
2948,1817641,2021-01-20,371,96,1697,183,9,Wien,467,279,34.4
2949,8488882,2021-01-20,1683,323,4337,591,10,Alle,2006,914,35.3
2950,350289,2021-01-21,43,8,139,17,1,Burgenland,51,25,32.0
2951,427206,2021-01-21,98,11,354,49,2,Kärnten,109,60,18.3
2952,2089186,2021-01-21,363,55,657,136,3,Niederösterreich,418,191,28.8
2953,1156144,2021-01-21,252,43,498,60,4,Oberösterreich,295,103,41.7
2954,451493,2021-01-21,103,21,122,24,5,Salzburg,124,45,46.7
2955,861388,2021-01-21,227,56,731,91,6,Steiermark,283,147,38.1
2956,881736,2021-01-21,111,31,131,14,7,Tirol,142,45,68.9
2957,485500,2021-01-21,45,11,72,10,8,Vorarlberg,56,21,52.4
2958,1832293,2021-01-21,364,104,1697,183,9,Wien,468,287,36.2
2959,8535235,2021-01-21,1606,340,4401,584,10,Alle,1946,924,36.8
2960,352275,2021-01-22,45,8,135,18,1,Burgenland,53,26,30.8
2961,428497,2021-01-22,86,10,366,50,2,Kärnten,96,60,16.7
2962,2096891,2021-01-22,366,54,654,120,3,Niederösterreich,420,174,31.0
2963,1174394,2021-01-22,245,41,505,59,4,Oberösterreich,286,100,41.0
2964,455931,2021-01-22,110,19,118,26,5,Salzburg,129,45,42.2
2965,861388,2021-01-22,231,53,723,93,6,Steiermark,284,146,36.3
2966,886084,2021-01-22,101,34,120,10,7,Tirol,135,44,77.3
2967,490297,2021-01-22,40,11,74,14,8,Vorarlberg,51,25,44.0
2968,1848134,2021-01-22,362,101,1697,183,9,Wien,463,284,35.6
2969,8593891,2021-01-22,1586,331,4392,573,10,Alle,1917,904,36.6
2970,360755,2021-01-23,34,8,144,17,1,Burgenland,42,25,32.0
2971,429156,2021-01-23,73,10,379,50,2,Kärnten,83,60,16.7
2972,2105221,2021-01-23,370,51,650,116,3,Niederösterreich,421,167,30.5
2973,1179321,2021-01-23,232,38,518,62,4,Oberösterreich,270,100,38.0
2974,468836,2021-01-23,104,21,114,24,5,Salzburg,125,45,46.7
2975,887529,2021-01-23,228,53,721,95,6,Steiermark,281,148,35.8
2976,890847,2021-01-23,100,29,117,15,7,Tirol,129,44,65.9
2977,496302,2021-01-23,38,10,76,15,8,Vorarlberg,48,25,40.0
2978,1865161,2021-01-23,346,103,1697,183,9,Wien,449,286,36.0
2979,8683128,2021-01-23,1525,323,4416,577,10,Alle,1848,900,35.9
2980,361192,2021-01-24,38,7,139,12,1,Burgenland,45,19,36.8
2981,429539,2021-01-24,72,9,246,32,2,Kärnten,81,41,22.0
2982,2111482,2021-01-24,359,53,661,121,3,Niederösterreich,412,174,30.5
2983,1184481,2021-01-24,240,38,810,89,4,Oberösterreich,278,127,29.9
2984,471712,2021-01-24,97,22,150,27,5,Salzburg,119,49,44.9
2985,901237,2021-01-24,223,48,777,112,6,Steiermark,271,160,30.0
2986,896047,2021-01-24,97,31,197,35,7,Tirol,128,66,47.0
2987,500945,2021-01-24,46,12,96,59,8,Vorarlberg,58,71,16.9
2988,1878487,2021-01-24,346,103,1697,183,9,Wien,449,286,36.0
2989,8735122,2021-01-24,1518,323,4773,670,10,Alle,1841,993,32.5
2990,363324,2021-01-25,43,6,137,15,1,Burgenland,49,21,28.6
2991,431300,2021-01-25,81,10,239,31,2,Kärnten,91,41,24.4
2992,2120739,2021-01-25,359,54,661,121,3,Niederösterreich,413,175,30.9
2993,1209927,2021-01-25,243,39,807,88,4,Oberösterreich,282,127,30.7
2994,472757,2021-01-25,103,21,144,28,5,Salzburg,124,49,42.9
2995,912384,2021-01-25,228,50,753,110,6,Steiermark,278,160,31.2
2996,901684,2021-01-25,102,32,191,36,7,Tirol,134,68,47.1
2997,502892,2021-01-25,47,12,94,60,8,Vorarlberg,59,72,16.7
2998,1887820,2021-01-25,342,97,1697,183,9,Wien,439,280,34.6
2999,8802827,2021-01-25,1548,321,4723,672,10,Alle,1869,993,32.3
3000,366055,2021-01-26,41,5,139,19,1,Burgenland,46,24,20.8
3001,441746,2021-01-26,89,9,234,32,2,Kärnten,98,41,22.0
3002,2124498,2021-01-26,367,53,653,114,3,Niederösterreich,420,167,31.7
3003,1225159,2021-01-26,237,37,813,90,4,Oberösterreich,274,127,29.1
3004,492193,2021-01-26,101,20,146,29,5,Salzburg,121,49,40.8
3005,936367,2021-01-26,239,48,741,112,6,Steiermark,287,160,30.0
3006,908278,2021-01-26,111,29,185,40,7,Tirol,140,69,42.0
3007,507027,2021-01-26,41,12,101,60,8,Vorarlberg,53,72,16.7
3008,1904760,2021-01-26,357,100,1735,199,9,Wien,457,299,33.4
3009,8906083,2021-01-26,1583,313,4747,695,10,Alle,1896,1008,31.1
3010,367437,2021-01-27,31,8,148,19,1,Burgenland,39,27,29.6
3011,442367,2021-01-27,87,9,238,32,2,Kärnten,96,41,22.0
3012,2136895,2021-01-27,357,53,653,108,3,Niederösterreich,410,161,32.9
3013,1245258,2021-01-27,220,37,830,90,4,Oberösterreich,257,127,29.1
3014,497159,2021-01-27,97,17,150,32,5,Salzburg,114,49,34.7
3015,953366,2021-01-27,226,44,759,117,6,Steiermark,270,161,27.3
3016,914163,2021-01-27,102,26,209,41,7,Tirol,128,67,38.8
3017,513570,2021-01-27,41,11,101,61,8,Vorarlberg,52,72,15.3
3018,1926929,2021-01-27,365,99,1674,173,9,Wien,464,272,36.4
3019,8997144,2021-01-27,1526,304,4762,673,10,Alle,1830,977,31.1
3020,370933,2021-01-28,35,9,146,16,1,Burgenland,44,25,36.0
3021,442908,2021-01-28,85,10,219,32,2,Kärnten,95,42,23.8
3022,2145980,2021-01-28,341,53,679,108,3,Niederösterreich,394,161,32.9
3023,1272766,2021-01-28,208,32,842,95,4,Oberösterreich,240,127,25.2
3024,501870,2021-01-28,88,18,159,31,5,Salzburg,106,49,36.7
3025,967699,2021-01-28,227,43,756,118,6,Steiermark,270,161,26.7
3026,920422,2021-01-28,91,28,212,38,7,Tirol,119,66,42.4
3027,519339,2021-01-28,36,11,106,59,8,Vorarlberg,47,70,15.7
3028,1947671,2021-01-28,367,100,1604,175,9,Wien,467,275,36.4
3029,9089588,2021-01-28,1478,304,4723,672,10,Alle,1782,976,31.1
3030,373613,2021-01-29,30,9,149,19,1,Burgenland,39,28,32.1
3031,451498,2021-01-29,81,9,225,32,2,Kärnten,90,41,22.0
3032,2154156,2021-01-29,330,52,690,97,3,Niederösterreich,382,149,34.9
3033,1284990,2021-01-29,188,34,862,86,4,Oberösterreich,222,120,28.3
3034,506813,2021-01-29,87,19,160,30,5,Salzburg,106,49,38.8
3035,978212,2021-01-29,217,37,786,121,6,Steiermark,254,158,23.4
3036,925227,2021-01-29,86,30,219,38,7,Tirol,116,68,44.1
3037,524937,2021-01-29,41,9,101,59,8,Vorarlberg,50,68,13.2
3038,1961170,2021-01-29,368,96,1604,175,9,Wien,464,271,35.4
3039,9160616,2021-01-29,1428,295,4796,657,10,Alle,1723,952,31.0
3040,385984,2021-01-30,36,8,141,17,1,Burgenland,44,25,32.0
3041,452148,2021-01-30,82,8,224,34,2,Kärnten,90,42,19.0
3042,2162851,2021-01-30,317,56,703,108,3,Niederösterreich,373,164,34.1
3043,1298759,2021-01-30,160,33,890,94,4,Oberösterreich,193,127,26.0
3044,514521,2021-01-30,88,19,161,30,5,Salzburg,107,49,38.8
3045,994793,2021-01-30,199,39,804,121,6,Steiermark,238,160,24.4
3046,954467,2021-01-30,96,30,206,36,7,Tirol,126,66,45.5
3047,531560,2021-01-30,40,10,101,60,8,Vorarlberg,50,70,14.3
3048,1990992,2021-01-30,367,94,1853,185,9,Wien,461,279,33.7
3049,9286075,2021-01-30,1385,297,5083,685,10,Alle,1682,982,30.2
3050,388800,2021-01-31,36,7,148,19,1,Burgenland,43,26,26.9
3051,452572,2021-01-31,80,7,224,34,2,Kärnten,87,41,17.1
3052,2169282,2021-01-31,316,55,704,125,3,Niederösterreich,371,180,30.6
3053,1308615,2021-01-31,160,35,890,92,4,Oberösterreich,195,127,27.6
3054,517081,2021-01-31,88,20,139,29,5,Salzburg,108,49,40.8
3055,1002589,2021-01-31,207,36,796,124,6,Steiermark,243,160,22.5
3056,960220,2021-01-31,98,31,202,36,7,Tirol,129,67,46.3
3057,536247,2021-01-31,42,9,99,60,8,Vorarlberg,51,69,13.0
3058,2020373,2021-01-31,360,97,2003,182,9,Wien,457,279,34.8
3059,9355779,2021-01-31,1387,297,5205,701,10,Alle,1684,998,29.8
3060,391679,2021-02-01,33,8,99,11,1,Burgenland,41,19,42.1
3061,455645,2021-02-01,85,9,219,33,2,Kärnten,94,42,21.4
3062,2175497,2021-02-01,330,54,690,114,3,Niederösterreich,384,168,32.1
3063,1377713,2021-02-01,164,34,886,93,4,Oberösterreich,198,127,26.8
3064,517757,2021-02-01,99,20,148,29,5,Salzburg,119,49,40.8
3065,1003509,2021-02-01,216,39,789,114,6,Steiermark,255,153,25.5
3066,965580,2021-02-01,98,34,195,34,7,Tirol,132,68,50.0
3067,538320,2021-02-01,42,9,99,60,8,Vorarlberg,51,69,13.0
3068,2056132,2021-02-01,366,87,2210,168,9,Wien,453,255,34.1
3069,9481832,2021-02-01,1433,294,5335,656,10,Alle,1727,950,30.9
3070,399066,2021-02-02,35,8,95,11,1,Burgenland,43,19,42.1
3071,464807,2021-02-02,81,9,224,30,2,Kärnten,90,39,23.1
3072,2177589,2021-02-02,347,53,673,103,3,Niederösterreich,400,156,34.0
3073,1382880,2021-02-02,151,31,899,93,4,Oberösterreich,182,124,25.0
3074,533522,2021-02-02,107,22,141,27,5,Salzburg,129,49,44.9
3075,1017663,2021-02-02,217,41,785,112,6,Steiermark,258,153,26.8
3076,971153,2021-02-02,97,30,190,39,7,Tirol,127,69,43.5
3077,538751,2021-02-02,36,9,106,60,8,Vorarlberg,45,69,13.0
3078,2077798,2021-02-02,358,97,1929,158,9,Wien,455,255,38.0
3079,9563229,2021-02-02,1429,300,5042,633,10,Alle,1729,933,32.2
3080,402624,2021-02-03,34,8,97,11,1,Burgenland,42,19,42.1
3081,473469,2021-02-03,77,9,225,30,2,Kärnten,86,39,23.1
3082,2282315,2021-02-03,322,54,698,96,3,Niederösterreich,376,150,36.0
3083,1385428,2021-02-03,156,31,519,72,4,Oberösterreich,187,103,30.1
3084,539755,2021-02-03,102,20,147,29,5,Salzburg,122,49,40.8
3085,1029004,2021-02-03,218,39,784,114,6,Steiermark,257,153,25.5
3086,977165,2021-02-03,98,31,191,36,7,Tirol,129,67,46.3
3087,549994,2021-02-03,35,9,107,60,8,Vorarlberg,44,69,13.0
3088,2105372,2021-02-03,341,102,1820,157,9,Wien,443,259,39.4
3089,9745126,2021-02-03,1383,303,4588,605,10,Alle,1686,908,33.4
3090,407041,2021-02-04,32,6,96,13,1,Burgenland,38,19,31.6
3091,474067,2021-02-04,81,9,219,32,2,Kärnten,90,41,22.0
3092,2292153,2021-02-04,305,50,715,103,3,Niederösterreich,355,153,32.7
3093,1418224,2021-02-04,143,26,532,77,4,Oberösterreich,169,103,25.2
3094,545845,2021-02-04,100,19,148,30,5,Salzburg,119,49,38.8
3095,1041514,2021-02-04,221,41,781,97,6,Steiermark,262,138,29.7
3096,982658,2021-02-04,101,33,193,38,7,Tirol,134,71,46.5
3097,557221,2021-02-04,29,10,113,60,8,Vorarlberg,39,70,14.3
3098,2134705,2021-02-04,330,104,1860,163,9,Wien,434,267,39.0
3099,9853428,2021-02-04,1342,298,4657,613,10,Alle,1640,911,32.7
3100,413852,2021-02-05,31,6,100,13,1,Burgenland,37,19,31.6
3101,474728,2021-02-05,80,8,227,33,2,Kärnten,88,41,19.5
3102,2302093,2021-02-05,300,59,720,110,3,Niederösterreich,359,169,34.9
3103,1430280,2021-02-05,131,27,544,76,4,Oberösterreich,158,103,26.2
3104,552424,2021-02-05,100,17,130,32,5,Salzburg,117,49,34.7
3105,1055337,2021-02-05,221,38,340,58,6,Steiermark,259,96,39.6
3106,989181,2021-02-05,98,32,192,37,7,Tirol,130,69,46.4
3107,564752,2021-02-05,31,8,111,60,8,Vorarlberg,39,68,11.8
3108,2157987,2021-02-05,312,105,1838,165,9,Wien,417,270,38.9
3109,9940634,2021-02-05,1304,300,4202,584,10,Alle,1604,884,33.9
3110,420976,2021-02-06,30,6,99,13,1,Burgenland,36,19,31.6
3111,481869,2021-02-06,78,8,229,33,2,Kärnten,86,41,19.5
3112,2312275,2021-02-06,314,58,706,116,3,Niederösterreich,372,174,33.3
3113,1475659,2021-02-06,116,30,559,73,4,Oberösterreich,146,103,29.1
3114,562367,2021-02-06,99,15,131,34,5,Salzburg,114,49,30.6
3115,1073627,2021-02-06,227,42,336,54,6,Steiermark,269,96,43.8
3116,996222,2021-02-06,93,28,198,42,7,Tirol,121,70,40.0
3117,573233,2021-02-06,26,5,118,63,8,Vorarlberg,31,68,7.4
3118,2204295,2021-02-06,306,108,2024,188,9,Wien,414,296,36.5
3119,10100523,2021-02-06,1289,300,4400,616,10,Alle,1589,916,32.8
3120,427284,2021-02-07,32,6,101,13,1,Burgenland,38,19,31.6
3121,482299,2021-02-07,75,7,232,34,2,Kärnten,82,41,17.1
3122,2410584,2021-02-07,292,56,728,119,3,Niederösterreich,348,175,32.0
3123,1507402,2021-02-07,119,29,556,74,4,Oberösterreich,148,103,28.2
3124,567109,2021-02-07,97,14,133,35,5,Salzburg,111,49,28.6
3125,1092245,2021-02-07,227,40,335,56,6,Steiermark,267,96,41.7
3126,1014160,2021-02-07,98,26,187,44,7,Tirol,124,70,37.1
3127,579703,2021-02-07,24,5,120,65,8,Vorarlberg,29,70,7.1
3128,2232384,2021-02-07,311,102,2101,174,9,Wien,413,276,37.0
3129,10313170,2021-02-07,1275,285,4493,614,10,Alle,1560,899,31.7
3130,432914,2021-02-08,34,5,94,14,1,Burgenland,39,19,26.3
3131,485878,2021-02-08,73,8,230,32,2,Kärnten,81,40,20.0
3132,2433779,2021-02-08,298,54,722,119,3,Niederösterreich,352,173,31.2
3133,1532577,2021-02-08,131,27,544,76,4,Oberösterreich,158,103,26.2
3134,567720,2021-02-08,97,15,133,34,5,Salzburg,112,49,30.6
3135,1111689,2021-02-08,233,42,327,54,6,Steiermark,275,96,43.8
3136,1026903,2021-02-08,96,27,187,43,7,Tirol,123,70,38.6
3137,583606,2021-02-08,26,3,118,66,8,Vorarlberg,29,69,4.3
3138,2267092,2021-02-08,311,100,2042,173,9,Wien,411,273,36.6
3139,10442158,2021-02-08,1299,281,4397,611,10,Alle,1580,892,31.5
3140,436790,2021-02-09,28,5,93,14,1,Burgenland,33,19,26.3
3141,501757,2021-02-09,77,8,228,32,2,Kärnten,85,40,20.0
3142,2479223,2021-02-09,296,54,724,96,3,Niederösterreich,350,150,36.0
3143,1568838,2021-02-09,126,28,549,75,4,Oberösterreich,154,103,27.2
3144,594275,2021-02-09,95,13,135,36,5,Salzburg,108,49,26.5
3145,1220651,2021-02-09,250,40,310,56,6,Steiermark,290,96,41.7
3146,1045442,2021-02-09,94,26,192,42,7,Tirol,120,68,38.2
3147,594613,2021-02-09,29,2,115,66,8,Vorarlberg,31,68,2.9
3148,2311180,2021-02-09,323,103,1833,177,9,Wien,426,280,36.8
3149,10752769,2021-02-09,1318,279,4179,594,10,Alle,1597,873,32.0
3150,445042,2021-02-10,41,5,92,14,1,Burgenland,46,19,26.3
3151,508471,2021-02-10,76,8,229,33,2,Kärnten,84,41,19.5
3152,2530636,2021-02-10,285,56,735,106,3,Niederösterreich,341,162,34.6
3153,1601073,2021-02-10,124,27,551,76,4,Oberösterreich,151,103,26.2
3154,609044,2021-02-10,84,12,146,37,5,Salzburg,96,49,24.5
3155,1251594,2021-02-10,233,38,318,58,6,Steiermark,271,96,39.6
3156,1059325,2021-02-10,81,25,210,41,7,Tirol,106,66,37.9
3157,608080,2021-02-10,22,4,122,62,8,Vorarlberg,26,66,6.1
3158,2360705,2021-02-10,316,90,1816,157,9,Wien,406,247,36.4
3159,10973970,2021-02-10,1262,265,4219,584,10,Alle,1527,849,31.2
3160,455925,2021-02-11,38,6,94,13,1,Burgenland,44,19,31.6
3161,525407,2021-02-11,77,9,228,33,2,Kärnten,86,42,21.4
3162,2588795,2021-02-11,283,55,737,104,3,Niederösterreich,338,159,34.6
3163,1616847,2021-02-11,122,23,553,80,4,Oberösterreich,145,103,22.3
3164,622985,2021-02-11,86,13,144,36,5,Salzburg,99,49,26.5
3165,1285524,2021-02-11,220,39,331,57,6,Steiermark,259,96,40.6
3166,1071314,2021-02-11,63,21,221,44,7,Tirol,84,65,32.3
3167,621458,2021-02-11,20,5,122,61,8,Vorarlberg,25,66,7.6
3168,2417196,2021-02-11,303,94,1832,162,9,Wien,397,256,36.7
3169,11205451,2021-02-11,1212,265,4262,590,10,Alle,1477,855,31.0
3170,463144,2021-02-12,33,6,97,13,1,Burgenland,39,19,31.6
3171,525887,2021-02-12,74,7,232,34,2,Kärnten,81,41,17.1
3172,2630551,2021-02-12,275,57,745,98,3,Niederösterreich,332,155,36.8
3173,1644551,2021-02-12,120,20,555,83,4,Oberösterreich,140,103,19.4
3174,636924,2021-02-12,80,14,150,35,5,Salzburg,94,49,28.6
3175,1312825,2021-02-12,211,38,339,59,6,Steiermark,249,97,39.2
3176,1087800,2021-02-12,67,21,215,43,7,Tirol,88,64,32.8
3177,635707,2021-02-12,21,6,121,61,8,Vorarlberg,27,67,9.0
3178,2471777,2021-02-12,270,94,1803,165,9,Wien,364,259,36.3
3179,11409166,2021-02-12,1151,263,4257,591,10,Alle,1414,854,30.8
3180,474483,2021-02-13,35,6,99,13,1,Burgenland,41,19,31.6
3181,526652,2021-02-13,72,7,232,34,2,Kärnten,79,41,17.1
3182,2691395,2021-02-13,253,57,767,100,3,Niederösterreich,310,157,36.3
3183,1670229,2021-02-13,109,16,566,87,4,Oberösterreich,125,103,15.5
3184,651739,2021-02-13,67,12,151,37,5,Salzburg,79,49,24.5
3185,1342383,2021-02-13,189,39,373,58,6,Steiermark,228,97,40.2
3186,1099796,2021-02-13,62,22,214,42,7,Tirol,84,64,34.4
3187,647797,2021-02-13,16,7,126,62,8,Vorarlberg,23,69,10.1
3188,2519013,2021-02-13,259,101,1998,182,9,Wien,360,283,35.7
3189,11623487,2021-02-13,1062,267,4526,615,10,Alle,1329,882,30.3
3190,483285,2021-02-14,32,7,99,12,1,Burgenland,39,19,36.8
3191,526883,2021-02-14,75,8,232,33,2,Kärnten,83,41,19.5
3192,2731420,2021-02-14,246,61,774,118,3,Niederösterreich,307,179,34.1
3193,1688699,2021-02-14,113,16,562,87,4,Oberösterreich,129,103,15.5
3194,656649,2021-02-14,72,12,146,38,5,Salzburg,84,50,24.0
3195,1362472,2021-02-14,186,35,376,62,6,Steiermark,221,97,36.1
3196,1110482,2021-02-14,65,20,211,46,7,Tirol,85,66,30.3
3197,654913,2021-02-14,17,9,125,62,8,Vorarlberg,26,71,12.7
3198,2548229,2021-02-14,250,87,2125,184,9,Wien,337,271,32.1
3199,11763032,2021-02-14,1056,255,4650,642,10,Alle,1311,897,28.4
3200,493043,2021-02-15,39,8,96,11,1,Burgenland,47,19,42.1
3201,528675,2021-02-15,76,7,227,33,2,Kärnten,83,40,17.5
3202,2752463,2021-02-15,263,58,757,118,3,Niederösterreich,321,176,33.0
3203,1710876,2021-02-15,111,21,564,82,4,Oberösterreich,132,103,20.4
3204,657125,2021-02-15,68,11,150,38,5,Salzburg,79,49,22.4
3205,1382947,2021-02-15,201,34,350,63,6,Steiermark,235,97,35.1
3206,1158699,2021-02-15,71,20,211,46,7,Tirol,91,66,30.3
3207,659500,2021-02-15,21,8,120,64,8,Vorarlberg,29,72,11.1
3208,2576722,2021-02-15,254,91,2071,179,9,Wien,345,270,33.7
3209,11920050,2021-02-15,1104,258,4546,634,10,Alle,1362,892,28.9
3210,501092,2021-02-16,36,10,94,9,1,Burgenland,46,19,52.6
3211,572902,2021-02-16,70,7,235,34,2,Kärnten,77,41,17.1
3212,2804645,2021-02-16,273,60,747,98,3,Niederösterreich,333,158,38.0
3213,1762713,2021-02-16,101,21,574,82,4,Oberösterreich,122,103,20.4
3214,682096,2021-02-16,72,13,146,36,5,Salzburg,85,49,26.5
3215,1422320,2021-02-16,174,33,375,65,6,Steiermark,207,98,33.7
3216,1174300,2021-02-16,67,22,222,46,7,Tirol,89,68,32.4
3217,672935,2021-02-16,20,9,121,63,8,Vorarlberg,29,72,12.5
3218,2618247,2021-02-16,276,89,1896,185,9,Wien,365,274,32.5
3219,12211250,2021-02-16,1089,264,4410,618,10,Alle,1353,882,29.9
3220,511962,2021-02-17,39,8,95,11,1,Burgenland,47,19,42.1
3221,583485,2021-02-17,76,7,232,33,2,Kärnten,83,40,17.5
3222,2845953,2021-02-17,267,60,753,101,3,Niederösterreich,327,161,37.3
3223,1788681,2021-02-17,106,17,569,86,4,Oberösterreich,123,103,16.5
3224,694455,2021-02-17,71,10,147,39,5,Salzburg,81,49,20.4
3225,1452094,2021-02-17,168,33,376,64,6,Steiermark,201,97,34.0
3226,1187069,2021-02-17,62,23,226,44,7,Tirol,85,67,34.3
3227,687574,2021-02-17,16,12,126,60,8,Vorarlberg,28,72,16.7
3228,2666336,2021-02-17,264,92,1860,178,9,Wien,356,270,34.1
3229,12417609,2021-02-17,1069,262,4384,616,10,Alle,1331,878,29.8
3230,521527,2021-02-18,37,10,97,9,1,Burgenland,47,19,52.6
3231,584327,2021-02-18,73,7,234,34,2,Kärnten,80,41,17.1
3232,2912869,2021-02-18,259,60,761,97,3,Niederösterreich,319,157,38.2
3233,1837652,2021-02-18,105,15,295,63,4,Oberösterreich,120,78,19.2
3234,706887,2021-02-18,71,9,138,40,5,Salzburg,80,49,18.4
3235,1479711,2021-02-18,150,36,394,61,6,Steiermark,186,97,37.1
3236,1217425,2021-02-18,60,25,222,44,7,Tirol,85,69,36.2
3237,700937,2021-02-18,19,12,123,60,8,Vorarlberg,31,72,16.7
3238,2730621,2021-02-18,253,90,1921,158,9,Wien,343,248,36.3
3239,12691956,2021-02-18,1027,264,4185,566,10,Alle,1291,830,31.8
3240,526789,2021-02-19,34,9,102,10,1,Burgenland,43,19,47.4
3241,585103,2021-02-19,72,7,235,34,2,Kärnten,79,41,17.1
3242,2961418,2021-02-19,252,63,768,94,3,Niederösterreich,315,157,40.1
3243,1863979,2021-02-19,106,12,294,66,4,Oberösterreich,118,78,15.4
3244,719438,2021-02-19,69,9,147,40,5,Salzburg,78,49,18.4
3245,1507916,2021-02-19,164,40,380,57,6,Steiermark,204,97,41.2
3246,1229255,2021-02-19,59,23,216,43,7,Tirol,82,66,34.8
3247,715276,2021-02-19,18,13,124,60,8,Vorarlberg,31,73,17.8
3248,2783547,2021-02-19,256,85,1726,181,9,Wien,341,266,32.0
3249,12892721,2021-02-19,1030,261,3992,585,10,Alle,1291,846,30.9
3250,556981,2021-02-20,37,9,100,13,1,Burgenland,46,22,40.9
3251,585710,2021-02-20,71,7,238,34,2,Kärnten,78,41,17.1
3252,3016465,2021-02-20,249,62,771,99,3,Niederösterreich,311,161,38.5
3253,1891184,2021-02-20,98,12,302,66,4,Oberösterreich,110,78,15.4
3254,734166,2021-02-20,68,9,148,40,5,Salzburg,77,49,18.4
3255,1538472,2021-02-20,149,41,429,57,6,Steiermark,190,98,41.8
3256,1244878,2021-02-20,51,23,218,46,7,Tirol,74,69,33.3
3257,727951,2021-02-20,20,12,121,62,8,Vorarlberg,32,74,16.2
3258,2833002,2021-02-20,256,86,1974,187,9,Wien,342,273,31.5
3259,13128809,2021-02-20,999,261,4301,604,10,Alle,1260,865,30.2
3260,561170,2021-02-21,37,9,101,13,1,Burgenland,46,22,40.9
3261,586173,2021-02-21,67,7,238,34,2,Kärnten,74,41,17.1
3262,3055616,2021-02-21,250,57,770,97,3,Niederösterreich,307,154,37.0
3263,1907173,2021-02-21,101,12,299,66,4,Oberösterreich,113,78,15.4
3264,739539,2021-02-21,68,5,148,44,5,Salzburg,73,49,10.2
3265,1563516,2021-02-21,154,43,424,55,6,Steiermark,197,98,43.9
3266,1318983,2021-02-21,59,22,212,46,7,Tirol,81,68,32.4
3267,734720,2021-02-21,20,12,122,62,8,Vorarlberg,32,74,16.2
3268,2860894,2021-02-21,262,87,2062,185,9,Wien,349,272,32.0
3269,13327784,2021-02-21,1018,254,4376,602,10,Alle,1272,856,29.7
3270,566648,2021-02-22,41,9,93,13,1,Burgenland,50,22,40.9
3271,587921,2021-02-22,74,9,237,32,2,Kärnten,83,41,22.0
3272,3078655,2021-02-22,260,61,760,103,3,Niederösterreich,321,164,37.2
3273,1929664,2021-02-22,105,14,295,64,4,Oberösterreich,119,78,17.9
3274,740101,2021-02-22,71,6,145,44,5,Salzburg,77,50,12.0
3275,1564782,2021-02-22,174,41,385,56,6,Steiermark,215,97,42.3
3276,1332740,2021-02-22,62,20,211,45,7,Tirol,82,65,30.8
3277,735753,2021-02-22,24,11,118,62,8,Vorarlberg,35,73,15.1
3278,2884696,2021-02-22,274,81,2062,185,9,Wien,355,266,30.5
3279,13420960,2021-02-22,1085,252,4306,604,10,Alle,1337,856,29.4
3280,573179,2021-02-23,33,11,99,11,1,Burgenland,44,22,50.0
3281,588669,2021-02-23,76,9,235,32,2,Kärnten,85,41,22.0
3282,3133817,2021-02-23,268,68,752,98,3,Niederösterreich,336,166,41.0
3283,1970950,2021-02-23,95,16,305,62,4,Oberösterreich,111,78,20.5
3284,764214,2021-02-23,65,6,151,43,5,Salzburg,71,49,12.2
3285,1607716,2021-02-23,170,44,390,54,6,Steiermark,214,98,44.9
3286,1347581,2021-02-23,68,19,203,45,7,Tirol,87,64,29.7
3287,755433,2021-02-23,22,9,120,62,8,Vorarlberg,31,71,12.7
3288,2937797,2021-02-23,280,91,1816,176,9,Wien,371,267,34.1
3289,13679356,2021-02-23,1077,273,4071,583,10,Alle,1350,856,31.9
3290,579324,2021-02-24,39,9,96,13,1,Burgenland,48,22,40.9
3291,644560,2021-02-24,79,10,231,31,2,Kärnten,89,41,24.4
3292,3183275,2021-02-24,252,68,768,97,3,Niederösterreich,320,165,41.2
3293,2001831,2021-02-24,97,14,303,64,4,Oberösterreich,111,78,17.9
3294,776432,2021-02-24,59,7,140,42,5,Salzburg,66,49,14.3
3295,1638030,2021-02-24,170,43,390,56,6,Steiermark,213,99,43.4
3296,1360402,2021-02-24,65,18,205,47,7,Tirol,83,65,27.7
3297,770279,2021-02-24,22,11,119,62,8,Vorarlberg,33,73,15.1
3298,2986542,2021-02-24,281,75,1711,157,9,Wien,356,232,32.3
3299,13940675,2021-02-24,1064,255,3963,569,10,Alle,1319,824,30.9
3300,597476,2021-02-25,41,8,94,14,1,Burgenland,49,22,36.4
3301,671597,2021-02-25,78,11,233,30,2,Kärnten,89,41,26.8
3302,3238808,2021-02-25,244,69,776,96,3,Niederösterreich,313,165,41.8
3303,2052333,2021-02-25,97,14,303,64,4,Oberösterreich,111,78,17.9
3304,788550,2021-02-25,58,11,141,38,5,Salzburg,69,49,22.4
3305,1666366,2021-02-25,169,38,393,59,6,Steiermark,207,97,39.2
3306,1376175,2021-02-25,62,19,202,47,7,Tirol,81,66,28.8
3307,784679,2021-02-25,26,9,116,63,8,Vorarlberg,35,72,12.5
3308,3033592,2021-02-25,266,69,1679,167,9,Wien,335,236,29.2
3309,14209576,2021-02-25,1041,248,3937,578,10,Alle,1289,826,30.0
3310,609615,2021-02-26,42,9,92,7,1,Burgenland,51,16,56.2
3311,672595,2021-02-26,75,12,234,29,2,Kärnten,87,41,29.3
3312,3288812,2021-02-26,245,71,775,97,3,Niederösterreich,316,168,42.3
3313,2092538,2021-02-26,97,16,306,62,4,Oberösterreich,113,78,20.5
3314,801139,2021-02-26,49,12,149,37,5,Salzburg,61,49,24.5
3315,1694570,2021-02-26,172,37,391,60,6,Steiermark,209,97,38.1
3316,1389051,2021-02-26,59,20,210,47,7,Tirol,79,67,29.9
3317,799209,2021-02-26,22,9,120,63,8,Vorarlberg,31,72,12.5
3318,3085297,2021-02-26,257,74,1698,169,9,Wien,331,243,30.5
3319,14432826,2021-02-26,1018,260,3975,571,10,Alle,1278,831,31.3
3320,626516,2021-02-27,34,9,99,12,1,Burgenland,43,21,42.9
3321,673383,2021-02-27,73,12,234,29,2,Kärnten,85,41,29.3
3322,3348005,2021-02-27,253,73,767,90,3,Niederösterreich,326,163,44.8
3323,2121412,2021-02-27,85,17,315,61,4,Oberösterreich,102,78,21.8
3324,816538,2021-02-27,56,13,143,36,5,Salzburg,69,49,26.5
3325,1728795,2021-02-27,158,36,405,61,6,Steiermark,194,97,37.1
3326,1490318,2021-02-27,58,19,188,45,7,Tirol,77,64,29.7
3327,812756,2021-02-27,21,7,123,65,8,Vorarlberg,28,72,9.7
3328,3134044,2021-02-27,250,74,1952,174,9,Wien,324,248,29.8
3329,14751767,2021-02-27,988,260,4226,573,10,Alle,1248,833,31.2
3330,632199,2021-02-28,33,10,107,12,1,Burgenland,43,22,45.5
3331,673818,2021-02-28,73,14,236,28,2,Kärnten,87,42,33.3
3332,3391018,2021-02-28,261,79,759,102,3,Niederösterreich,340,181,43.6
3333,2140416,2021-02-28,90,16,310,62,4,Oberösterreich,106,78,20.5
3334,822663,2021-02-28,56,15,143,34,5,Salzburg,71,49,30.6
3335,1756692,2021-02-28,165,35,398,61,6,Steiermark,200,96,36.5
3336,1506506,2021-02-28,60,21,185,45,7,Tirol,81,66,31.8
3337,820454,2021-02-28,23,7,120,63,8,Vorarlberg,30,70,10.0
3338,3164015,2021-02-28,261,86,2059,176,9,Wien,347,262,32.8
3339,14907781,2021-02-28,1022,283,4317,583,10,Alle,1305,866,32.7
3340,638575,2021-03-01,36,10,106,12,1,Burgenland,46,22,45.5
3341,675557,2021-03-01,81,15,228,28,2,Kärnten,96,43,34.9
3342,3400756,2021-03-01,267,82,753,96,3,Niederösterreich,349,178,46.1
3343,2162517,2021-03-01,100,20,300,58,4,Oberösterreich,120,78,25.6
3344,823353,2021-03-01,58,15,141,34,5,Salzburg,73,49,30.6
3345,1758065,2021-03-01,168,39,379,60,6,Steiermark,207,99,39.4
3346,1521757,2021-03-01,63,24,183,39,7,Tirol,87,63,38.1
3347,825612,2021-03-01,22,6,120,63,8,Vorarlberg,28,69,8.7
3348,3197153,2021-03-01,278,85,2135,173,9,Wien,363,258,32.9
3349,15003345,2021-03-01,1073,296,4345,563,10,Alle,1369,859,34.5
3350,645941,2021-03-02,41,13,96,9,1,Burgenland,54,22,59.1
3351,704089,2021-03-02,75,16,232,27,2,Kärnten,91,43,37.2
3352,3471229,2021-03-02,303,78,717,88,3,Niederösterreich,381,166,47.0
3353,2241062,2021-03-02,114,16,286,62,4,Oberösterreich,130,78,20.5
3354,847370,2021-03-02,53,16,146,33,5,Salzburg,69,49,32.7
3355,1801508,2021-03-02,165,40,381,60,6,Steiermark,205,100,40.0
3356,1539898,2021-03-02,59,24,185,31,7,Tirol,83,55,43.6
3357,842170,2021-03-02,22,5,120,64,8,Vorarlberg,27,69,7.2
3358,3264872,2021-03-02,292,93,1962,170,9,Wien,385,263,35.4
3359,15358139,2021-03-02,1124,301,4125,544,10,Alle,1425,845,35.6
3360,656824,2021-03-03,38,13,98,9,1,Burgenland,51,22,59.1
3361,708065,2021-03-03,78,17,227,26,2,Kärnten,95,43,39.5
3362,3525810,2021-03-03,290,81,730,89,3,Niederösterreich,371,170,47.6
3363,2276421,2021-03-03,103,21,297,57,4,Oberösterreich,124,78,26.9
3364,859248,2021-03-03,56,15,133,34,5,Salzburg,71,49,30.6
3365,1852502,2021-03-03,165,36,376,64,6,Steiermark,201,100,36.0
3366,1552380,2021-03-03,54,24,191,31,7,Tirol,78,55,43.6
3367,855489,2021-03-03,23,6,119,62,8,Vorarlberg,29,68,8.8
3368,3316131,2021-03-03,290,100,1907,168,9,Wien,390,268,37.3
3369,15602870,2021-03-03,1097,313,4078,540,10,Alle,1410,853,36.7
3370,665306,2021-03-04,46,13,85,9,1,Burgenland,59,22,59.1
3371,709254,2021-03-04,79,16,226,27,2,Kärnten,95,43,37.2
3372,3580743,2021-03-04,292,84,728,85,3,Niederösterreich,376,169,49.7
3373,2332134,2021-03-04,97,21,303,57,4,Oberösterreich,118,78,26.9
3374,871522,2021-03-04,60,14,129,35,5,Salzburg,74,49,28.6
3375,1899187,2021-03-04,160,38,373,62,6,Steiermark,198,100,38.0
3376,1569811,2021-03-04,67,22,176,32,7,Tirol,89,54,40.7
3377,868793,2021-03-04,24,4,117,64,8,Vorarlberg,28,68,5.9
3378,3367370,2021-03-04,317,90,1905,169,9,Wien,407,259,34.7
3379,15864120,2021-03-04,1142,302,4042,540,10,Alle,1444,842,35.9
3380,677110,2021-03-05,40,14,84,9,1,Burgenland,54,23,60.9
3381,710375,2021-03-05,89,15,215,26,2,Kärnten,104,41,36.6
3382,3631722,2021-03-05,273,89,747,80,3,Niederösterreich,362,169,52.7
3383,2368282,2021-03-05,96,24,304,54,4,Oberösterreich,120,78,30.8
3384,914767,2021-03-05,68,13,121,36,5,Salzburg,81,49,26.5
3385,1929023,2021-03-05,176,36,358,65,6,Steiermark,212,101,35.6
3386,1587729,2021-03-05,64,23,181,31,7,Tirol,87,54,42.6
3387,882629,2021-03-05,23,4,120,60,8,Vorarlberg,27,64,6.2
3388,3421978,2021-03-05,285,107,1830,159,9,Wien,392,266,40.2
3389,16123615,2021-03-05,1114,325,3960,520,10,Alle,1439,845,38.5
3390,692887,2021-03-06,46,13,88,11,1,Burgenland,59,24,54.2
3391,711306,2021-03-06,81,15,215,26,2,Kärnten,96,41,36.6
3392,3693241,2021-03-06,281,87,739,79,3,Niederösterreich,368,166,52.4
3393,2407310,2021-03-06,112,23,288,55,4,Oberösterreich,135,78,29.5
3394,931315,2021-03-06,71,11,118,38,5,Salzburg,82,49,22.4
3395,1966099,2021-03-06,180,34,368,65,6,Steiermark,214,99,34.3
3396,1604167,2021-03-06,60,22,183,36,7,Tirol,82,58,37.9
3397,896689,2021-03-06,22,4,122,61,8,Vorarlberg,26,65,6.2
3398,3471274,2021-03-06,285,107,2162,175,9,Wien,392,282,37.9
3399,16374288,2021-03-06,1138,316,4283,546,10,Alle,1454,862,36.7
3400,694733,2021-03-07,54,12,85,13,1,Burgenland,66,25,48.0
3401,711909,2021-03-07,82,16,215,25,2,Kärnten,98,41,39.0
3402,3738592,2021-03-07,271,84,749,96,3,Niederösterreich,355,180,46.7
3403,2428659,2021-03-07,115,21,285,57,4,Oberösterreich,136,78,26.9
3404,939879,2021-03-07,76,14,115,35,5,Salzburg,90,49,28.6
3405,1993544,2021-03-07,185,36,365,63,6,Steiermark,221,99,36.4
3406,1619308,2021-03-07,64,21,179,37,7,Tirol,85,58,36.2
3407,904537,2021-03-07,23,4,119,65,8,Vorarlberg,27,69,5.8
3408,3501971,2021-03-07,285,109,2118,174,9,Wien,394,283,38.5
3409,16533132,2021-03-07,1155,317,4230,565,10,Alle,1472,882,35.9
3410,705722,2021-03-08,60,11,84,8,1,Burgenland,71,19,57.9
3411,713785,2021-03-08,80,17,219,26,2,Kärnten,97,43,39.5
3412,3765805,2021-03-08,280,85,740,98,3,Niederösterreich,365,183,46.4
3413,2452634,2021-03-08,124,24,276,54,4,Oberösterreich,148,78,30.8
3414,947009,2021-03-08,79,14,130,35,5,Salzburg,93,49,28.6
3415,1996501,2021-03-08,204,38,330,61,6,Steiermark,242,99,38.4
3416,1633325,2021-03-08,71,22,173,37,7,Tirol,93,59,37.3
3417,911122,2021-03-08,24,4,118,65,8,Vorarlberg,28,69,5.8
3418,3529309,2021-03-08,304,118,2027,163,9,Wien,422,281,42.0
3419,16655212,2021-03-08,1226,333,4097,547,10,Alle,1559,880,37.8
3420,716398,2021-03-09,61,10,80,9,1,Burgenland,71,19,52.6
3421,763750,2021-03-09,84,15,192,28,2,Kärnten,99,43,34.9
3422,3824765,2021-03-09,312,82,708,86,3,Niederösterreich,394,168,48.8
3423,2517626,2021-03-09,120,26,280,52,4,Oberösterreich,146,78,33.3
3424,982741,2021-03-09,90,13,136,36,5,Salzburg,103,49,26.5
3425,2066437,2021-03-09,212,34,307,65,6,Steiermark,246,99,34.3
3426,1645194,2021-03-09,68,19,177,38,7,Tirol,87,57,33.3
3427,926254,2021-03-09,21,4,121,65,8,Vorarlberg,25,69,5.8
3428,3607954,2021-03-09,319,126,1874,156,9,Wien,445,282,44.7
3429,17051119,2021-03-09,1287,329,3875,535,10,Alle,1616,864,38.1
3430,725692,2021-03-10,64,12,75,7,1,Burgenland,76,19,63.2
3431,780153,2021-03-10,81,15,196,29,2,Kärnten,96,44,34.1
3432,3885068,2021-03-10,304,75,716,81,3,Niederösterreich,379,156,48.1
3433,2560979,2021-03-10,127,25,273,53,4,Oberösterreich,152,78,32.1
3434,1001876,2021-03-10,87,13,139,36,5,Salzburg,100,49,26.5
3435,2117895,2021-03-10,207,39,311,58,6,Steiermark,246,97,40.2
3436,1656543,2021-03-10,65,21,176,35,7,Tirol,86,56,37.5
3437,940650,2021-03-10,15,4,127,65,8,Vorarlberg,19,69,5.8
3438,3660447,2021-03-10,323,120,1778,158,9,Wien,443,278,43.2
3439,17329303,2021-03-10,1273,324,3791,522,10,Alle,1597,846,38.3
3440,735955,2021-03-11,58,15,79,5,1,Burgenland,73,20,75.0
3441,780828,2021-03-11,76,15,201,28,2,Kärnten,91,43,34.9
3442,3930268,2021-03-11,313,76,707,95,3,Niederösterreich,389,171,44.4
3443,2617695,2021-03-11,124,28,276,50,4,Oberösterreich,152,78,35.9
3444,1023271,2021-03-11,83,17,124,32,5,Salzburg,100,49,34.7
3445,2145853,2021-03-11,191,42,327,56,6,Steiermark,233,98,42.9
3446,1669705,2021-03-11,68,24,172,32,7,Tirol,92,56,42.9
3447,953849,2021-03-11,13,4,129,62,8,Vorarlberg,17,66,6.1
3448,3691533,2021-03-11,316,121,1831,155,9,Wien,437,276,43.8
3449,17548957,2021-03-11,1242,342,3846,515,10,Alle,1584,857,39.9
3450,745729,2021-03-12,59,15,83,5,1,Burgenland,74,20,75.0
3451,782016,2021-03-12,75,17,202,26,2,Kärnten,92,43,39.5
3452,4004202,2021-03-12,317,79,703,86,3,Niederösterreich,396,165,47.9
3453,2658827,2021-03-12,131,30,269,48,4,Oberösterreich,161,78,38.5
3454,1042456,2021-03-12,81,18,126,31,5,Salzburg,99,49,36.7
3455,2174570,2021-03-12,197,38,321,58,6,Steiermark,235,96,39.6
3456,1762040,2021-03-12,72,25,170,33,7,Tirol,97,58,43.1
3457,968333,2021-03-12,12,4,130,62,8,Vorarlberg,16,66,6.1
3458,3768674,2021-03-12,325,120,1726,159,9,Wien,445,279,43.0
3459,17906847,2021-03-12,1269,346,3730,508,10,Alle,1615,854,40.5
3460,765111,2021-03-13,59,15,76,5,1,Burgenland,74,20,75.0
3461,783011,2021-03-13,74,16,202,26,2,Kärnten,90,42,38.1
3462,4079284,2021-03-13,303,82,717,78,3,Niederösterreich,385,160,51.2
3463,2699892,2021-03-13,138,34,262,44,4,Oberösterreich,172,78,43.6
3464,1065238,2021-03-13,84,16,126,33,5,Salzburg,100,49,32.7
3465,2215308,2021-03-13,195,36,322,59,6,Steiermark,231,95,37.9
3466,1780612,2021-03-13,76,25,173,33,7,Tirol,101,58,43.1
3467,982335,2021-03-13,13,4,129,64,8,Vorarlberg,17,68,5.9
3468,3807817,2021-03-13,343,128,1932,158,9,Wien,471,286,44.8
3469,18178608,2021-03-13,1285,356,3939,500,10,Alle,1641,856,41.6
3470,772126,2021-03-14,56,16,80,7,1,Burgenland,72,23,69.6
3471,783426,2021-03-14,80,16,202,26,2,Kärnten,96,42,38.1
3472,4130698,2021-03-14,293,87,727,103,3,Niederösterreich,380,190,45.8
3473,2722516,2021-03-14,149,35,251,43,4,Oberösterreich,184,78,44.9
3474,1075448,2021-03-14,84,14,127,35,5,Salzburg,98,49,28.6
3475,2243171,2021-03-14,213,33,321,66,6,Steiermark,246,99,33.3
3476,1794959,2021-03-14,82,23,168,37,7,Tirol,105,60,38.3
3477,990424,2021-03-14,13,2,129,64,8,Vorarlberg,15,66,3.0
3478,3833275,2021-03-14,352,126,2016,169,9,Wien,478,295,42.7
3479,18346043,2021-03-14,1322,352,4021,550,10,Alle,1674,902,39.0
3480,778154,2021-03-15,61,18,78,8,1,Burgenland,79,26,69.2
3481,785396,2021-03-15,85,16,192,26,2,Kärnten,101,42,38.1
3482,4167187,2021-03-15,315,85,705,102,3,Niederösterreich,400,187,45.5
3483,2749652,2021-03-15,167,41,233,37,4,Oberösterreich,208,78,52.6
3484,1077012,2021-03-15,77,17,128,32,5,Salzburg,94,49,34.7
3485,2247450,2021-03-15,223,36,312,64,6,Steiermark,259,100,36.0
3486,1811508,2021-03-15,85,24,166,38,7,Tirol,109,62,38.7
3487,998950,2021-03-15,13,2,129,64,8,Vorarlberg,15,66,3.0
3488,3869837,2021-03-15,380,134,1955,149,9,Wien,514,283,47.3
3489,18485146,2021-03-15,1406,373,3898,520,10,Alle,1779,893,41.8
3490,790271,2021-03-16,54,18,82,6,1,Burgenland,72,24,75.0
3491,786786,2021-03-16,88,17,193,24,2,Kärnten,105,41,41.5
3492,4239419,2021-03-16,342,86,678,93,3,Niederösterreich,428,179,48.0
3493,2819376,2021-03-16,171,43,229,35,4,Oberösterreich,214,78,55.1
3494,1102571,2021-03-16,69,18,135,31,5,Salzburg,87,49,36.7
3495,2345419,2021-03-16,225,45,293,52,6,Steiermark,270,97,46.4
3496,1826809,2021-03-16,84,22,171,37,7,Tirol,106,59,37.3
3497,1015789,2021-03-16,10,3,132,63,8,Vorarlberg,13,66,4.5
3498,3914427,2021-03-16,395,143,1768,151,9,Wien,538,294,48.6
3499,18840867,2021-03-16,1438,395,3681,492,10,Alle,1833,887,44.5
3500,799358,2021-03-17,52,19,85,5,1,Burgenland,71,24,79.2
3501,870998,2021-03-17,88,15,193,24,2,Kärnten,103,39,38.5
3502,4307909,2021-03-17,341,89,679,88,3,Niederösterreich,430,177,50.3
3503,2851427,2021-03-17,160,46,290,57,4,Oberösterreich,206,103,44.7
3504,1122193,2021-03-17,71,14,136,35,5,Salzburg,85,49,28.6
3505,2396525,2021-03-17,223,40,293,56,6,Steiermark,263,96,41.7
3506,1937323,2021-03-17,82,26,173,35,7,Tirol,108,61,42.6
3507,1033799,2021-03-17,12,3,130,63,8,Vorarlberg,15,66,4.5
3508,3957995,2021-03-17,420,144,1695,156,9,Wien,564,300,48.0
3509,19277527,2021-03-17,1449,396,3674,519,10,Alle,1845,915,43.3
3510,809593,2021-03-18,52,18,85,6,1,Burgenland,70,24,75.0
3511,871799,2021-03-18,84,16,193,27,2,Kärnten,100,43,37.2
3512,4377441,2021-03-18,331,85,689,84,3,Niederösterreich,416,169,50.3
3513,2927953,2021-03-18,164,46,286,57,4,Oberösterreich,210,103,44.7
3514,1142497,2021-03-18,74,16,133,33,5,Salzburg,90,49,32.7
3515,2426106,2021-03-18,235,42,281,55,6,Steiermark,277,97,43.3
3516,1953024,2021-03-18,89,24,166,36,7,Tirol,113,60,40.0
3517,1064740,2021-03-18,13,4,129,63,8,Vorarlberg,17,67,6.0
3518,4002957,2021-03-18,409,137,1685,147,9,Wien,546,284,48.2
3519,19576110,2021-03-18,1451,388,3647,508,10,Alle,1839,896,43.3
3520,823041,2021-03-19,52,16,83,8,1,Burgenland,68,24,66.7
3521,872716,2021-03-19,73,18,201,25,2,Kärnten,91,43,41.9
3522,4452446,2021-03-19,337,82,683,77,3,Niederösterreich,419,159,51.6
3523,2958465,2021-03-19,158,50,292,53,4,Oberösterreich,208,103,48.5
3524,1161332,2021-03-19,76,20,131,29,5,Salzburg,96,49,40.8
3525,2459841,2021-03-19,253,45,264,53,6,Steiermark,298,98,45.9
3526,1969077,2021-03-19,92,23,173,35,7,Tirol,115,58,39.7
3527,1098690,2021-03-19,15,3,127,64,8,Vorarlberg,18,67,4.5
3528,4049950,2021-03-19,406,143,1654,139,9,Wien,549,282,50.7
3529,19845558,2021-03-19,1462,400,3608,483,10,Alle,1862,883,45.3
3530,835606,2021-03-20,49,15,83,9,1,Burgenland,64,24,62.5
3531,873766,2021-03-20,73,18,201,25,2,Kärnten,91,43,41.9
3532,4526483,2021-03-20,335,80,685,79,3,Niederösterreich,415,159,50.3
3533,2991505,2021-03-20,164,52,286,51,4,Oberösterreich,216,103,50.5
3534,1184231,2021-03-20,79,20,127,29,5,Salzburg,99,49,40.8
3535,2493346,2021-03-20,246,45,272,53,6,Steiermark,291,98,45.9
3536,1986242,2021-03-20,86,23,178,39,7,Tirol,109,62,37.1
3537,1141970,2021-03-20,16,2,126,64,8,Vorarlberg,18,66,3.0
3538,4090443,2021-03-20,390,138,1882,155,9,Wien,528,293,47.1
3539,20123592,2021-03-20,1438,393,3840,504,10,Alle,1831,897,43.8
3540,842503,2021-03-21,49,16,89,9,1,Burgenland,65,25,64.0
3541,874442,2021-03-21,70,19,201,25,2,Kärnten,89,44,43.2
3542,4579366,2021-03-21,327,80,693,90,3,Niederösterreich,407,170,47.1
3543,3014683,2021-03-21,176,54,274,49,4,Oberösterreich,230,103,52.4
3544,1194163,2021-03-21,85,21,122,28,5,Salzburg,106,49,42.9
3545,2519857,2021-03-21,258,48,260,49,6,Steiermark,306,97,49.5
3546,1990374,2021-03-21,87,24,176,39,7,Tirol,111,63,38.1
3547,1182027,2021-03-21,17,2,125,64,8,Vorarlberg,19,66,3.0
3548,4119141,2021-03-21,426,152,1948,163,9,Wien,578,315,48.3
3549,20316556,2021-03-21,1495,416,3888,516,10,Alle,1911,932,44.6
3550,849033,2021-03-22,51,16,86,9,1,Burgenland,67,25,64.0
3551,876391,2021-03-22,74,19,199,25,2,Kärnten,93,44,43.2
3552,4617906,2021-03-22,331,84,689,79,3,Niederösterreich,415,163,51.5
3553,3040358,2021-03-22,193,57,257,46,4,Oberösterreich,250,103,55.3
3554,1195805,2021-03-22,85,19,108,30,5,Salzburg,104,49,38.8
3555,2521739,2021-03-22,276,51,241,47,6,Steiermark,327,98,52.0
3556,2019901,2021-03-22,94,23,169,40,7,Tirol,117,63,36.5
3557,1205686,2021-03-22,17,2,125,64,8,Vorarlberg,19,66,3.0
3558,4149666,2021-03-22,452,165,1900,153,9,Wien,617,318,51.9
3559,20476485,2021-03-22,1573,436,3774,493,10,Alle,2009,929,46.9
3560,861558,2021-03-23,55,16,82,9,1,Burgenland,71,25,64.0
3561,929695,2021-03-23,73,17,199,27,2,Kärnten,90,44,38.6
3562,4694800,2021-03-23,343,85,677,68,3,Niederösterreich,428,153,55.6
3563,3088116,2021-03-23,190,57,260,46,4,Oberösterreich,247,103,55.3
3564,1232030,2021-03-23,97,18,110,31,5,Salzburg,115,49,36.7
3565,2572266,2021-03-23,275,50,243,47,6,Steiermark,325,97,51.5
3566,2036946,2021-03-23,95,25,158,40,7,Tirol,120,65,38.5
3567,1234614,2021-03-23,18,2,124,64,8,Vorarlberg,20,66,3.0
3568,4196267,2021-03-23,468,168,1752,156,9,Wien,636,324,51.9
3569,20846292,2021-03-23,1614,438,3605,488,10,Alle,2052,926,47.3
3570,872896,2021-03-24,58,18,77,7,1,Burgenland,76,25,72.0
3571,931134,2021-03-24,75,16,196,27,2,Kärnten,91,43,37.2
3572,4767494,2021-03-24,352,91,668,72,3,Niederösterreich,443,163,55.8
3573,3129752,2021-03-24,209,54,241,49,4,Oberösterreich,263,103,52.4
3574,1252911,2021-03-24,98,21,105,28,5,Salzburg,119,49,42.9
3575,2625970,2021-03-24,269,48,248,48,6,Steiermark,317,96,50.0
3576,2053643,2021-03-24,92,25,167,38,7,Tirol,117,63,39.7
3577,1273158,2021-03-24,19,1,123,64,8,Vorarlberg,20,65,1.5
3578,4240176,2021-03-24,463,176,1670,148,9,Wien,639,324,54.3
3579,21147134,2021-03-24,1635,450,3495,481,10,Alle,2085,931,48.3
3580,884164,2021-03-25,68,19,71,6,1,Burgenland,87,25,76.0
3581,932192,2021-03-25,77,17,194,26,2,Kärnten,94,43,39.5
3582,4855242,2021-03-25,355,94,665,71,3,Niederösterreich,449,165,57.0
3583,3184428,2021-03-25,211,56,239,47,4,Oberösterreich,267,103,54.4
3584,1274885,2021-03-25,95,22,112,27,5,Salzburg,117,49,44.9
3585,2657562,2021-03-25,261,54,256,43,6,Steiermark,315,97,55.7
3586,2178261,2021-03-25,109,25,153,36,7,Tirol,134,61,41.0
3587,1313899,2021-03-25,21,1,121,64,8,Vorarlberg,22,65,1.5
3588,4284829,2021-03-25,444,167,1594,148,9,Wien,611,315,53.0
3589,21565462,2021-03-25,1641,455,3405,468,10,Alle,2096,923,49.3
3590,899869,2021-03-26,74,20,62,7,1,Burgenland,94,27,74.1
3591,933153,2021-03-26,73,15,197,29,2,Kärnten,88,44,34.1
3592,4935497,2021-03-26,357,99,663,70,3,Niederösterreich,456,169,58.6
3593,3218056,2021-03-26,221,64,229,39,4,Oberösterreich,285,103,62.1
3594,1295737,2021-03-26,96,24,117,25,5,Salzburg,120,49,49.0
3595,2663502,2021-03-26,256,58,261,39,6,Steiermark,314,97,59.8
3596,2194887,2021-03-26,112,25,172,38,7,Tirol,137,63,39.7
3597,1337430,2021-03-26,21,1,122,64,8,Vorarlberg,22,65,1.5
3598,4572963,2021-03-26,483,165,1641,146,9,Wien,648,311,53.1
3599,22051094,2021-03-26,1693,471,3464,457,10,Alle,2164,928,50.8
3600,917549,2021-03-27,71,25,122,2,1,Burgenland,96,27,92.6
3601,934164,2021-03-27,62,17,197,27,2,Kärnten,79,44,38.6
3602,5025191,2021-03-27,343,105,677,57,3,Niederösterreich,448,162,64.8
3603,3252545,2021-03-27,213,67,337,64,4,Oberösterreich,280,131,51.1
3604,1320211,2021-03-27,94,23,113,28,5,Salzburg,117,51,45.1
3605,2698663,2021-03-27,258,54,261,44,6,Steiermark,312,98,55.1
3606,2211937,2021-03-27,116,29,175,30,7,Tirol,145,59,49.2
3607,1196919,2021-03-27,21,1,122,64,8,Vorarlberg,22,65,1.5
3608,4637257,2021-03-27,473,187,1825,141,9,Wien,660,328,57.0
3609,22194436,2021-03-27,1651,508,3829,457,10,Alle,2159,965,52.6
3610,927611,2021-03-28,75,24,112,3,1,Burgenland,99,27,88.9
3611,934873,2021-03-28,67,17,197,27,2,Kärnten,84,44,38.6
3612,5086477,2021-03-28,325,110,695,74,3,Niederösterreich,435,184,59.8
3613,3276807,2021-03-28,218,69,332,62,4,Oberösterreich,287,131,52.7
3614,1331590,2021-03-28,95,23,112,28,5,Salzburg,118,51,45.1
3615,2755439,2021-03-28,255,55,268,43,6,Steiermark,310,98,56.1
3616,2229212,2021-03-28,118,28,176,34,7,Tirol,146,62,45.2
3617,1218096,2021-03-28,24,1,117,64,8,Vorarlberg,25,65,1.5
3618,4695367,2021-03-28,459,191,318,173,9,Wien,650,364,52.5
3619,22455472,2021-03-28,1636,518,2327,508,10,Alle,2154,1026,50.5
3620,934721,2021-03-29,70,21,124,6,1,Burgenland,91,27,77.8
3621,936879,2021-03-29,67,18,199,26,2,Kärnten,85,44,40.9
3622,5124040,2021-03-29,340,113,680,68,3,Niederösterreich,453,181,62.4
3623,3301345,2021-03-29,232,69,318,62,4,Oberösterreich,301,131,52.7
3624,1333746,2021-03-29,97,24,112,27,5,Salzburg,121,51,47.1
3625,2758920,2021-03-29,264,59,258,41,6,Steiermark,323,100,59.0
3626,2247085,2021-03-29,129,28,165,31,7,Tirol,157,59,47.5
3627,1231825,2021-03-29,26,1,116,65,8,Vorarlberg,27,66,1.5
3628,4741699,2021-03-29,485,204,292,160,9,Wien,689,364,56.0
3629,22610260,2021-03-29,1710,537,2264,486,10,Alle,2247,1023,52.5
3630,949104,2021-03-30,64,19,128,10,1,Burgenland,83,29,65.5
3631,972454,2021-03-30,68,18,199,26,2,Kärnten,86,44,40.9
3632,5245241,2021-03-30,358,116,662,67,3,Niederösterreich,474,183,63.4
3633,3330249,2021-03-30,247,72,303,59,4,Oberösterreich,319,131,55.0
3634,1368198,2021-03-30,99,23,120,29,5,Salzburg,122,52,44.2
3635,2805617,2021-03-30,260,56,265,44,6,Steiermark,316,100,56.0
3636,2357712,2021-03-30,130,26,164,34,7,Tirol,156,60,43.3
3637,1260864,2021-03-30,22,2,120,65,8,Vorarlberg,24,67,3.0
3638,4803867,2021-03-30,522,206,255,158,9,Wien,728,364,56.6
3639,23093306,2021-03-30,1770,538,2216,492,10,Alle,2308,1030,52.2
3640,961060,2021-03-31,65,17,131,18,1,Burgenland,82,35,48.6
3641,990186,2021-03-31,66,13,199,28,2,Kärnten,79,41,31.7
3642,5335669,2021-03-31,360,121,660,80,3,Niederösterreich,481,201,60.2
3643,3367362,2021-03-31,251,71,299,60,4,Oberösterreich,322,131,54.2
3644,1388828,2021-03-31,98,19,121,33,5,Salzburg,117,52,36.5
3645,2862543,2021-03-31,270,54,257,45,6,Steiermark,324,99,54.5
3646,2376380,2021-03-31,124,25,169,35,7,Tirol,149,60,41.7
3647,1287471,2021-03-31,20,3,122,64,8,Vorarlberg,23,67,4.5
3648,4882022,2021-03-31,533,208,244,156,9,Wien,741,364,57.1
3649,23451521,2021-03-31,1787,531,2202,519,10,Alle,2318,1050,50.6
3650,974111,2021-04-01,59,18,160,17,1,Burgenland,77,35,51.4
3651,1020563,2021-04-01,75,10,191,30,2,Kärnten,85,40,25.0
3652,5413536,2021-04-01,353,118,667,88,3,Niederösterreich,471,206,57.3
3653,3419985,2021-04-01,256,70,294,61,4,Oberösterreich,326,131,53.4
3654,1410452,2021-04-01,97,19,122,33,5,Salzburg,116,52,36.5
3655,2894660,2021-04-01,272,54,258,45,6,Steiermark,326,99,54.5
3656,2395114,2021-04-01,126,27,144,36,7,Tirol,153,63,42.9
3657,1316236,2021-04-01,19,3,123,64,8,Vorarlberg,22,67,4.5
3658,4960583,2021-04-01,508,215,269,149,9,Wien,723,364,59.1
3659,23805240,2021-04-01,1765,534,2228,523,10,Alle,2299,1057,50.5
3660,982101,2021-04-02,61,20,159,15,1,Burgenland,81,35,57.1
3661,1021313,2021-04-02,71,11,191,29,2,Kärnten,82,40,27.5
3662,5481795,2021-04-02,347,118,673,85,3,Niederösterreich,465,203,58.1
3663,3453475,2021-04-02,255,68,295,63,4,Oberösterreich,323,131,51.9
3664,1432749,2021-04-02,94,20,125,32,5,Salzburg,114,52,38.5
3665,2934598,2021-04-02,277,53,256,46,6,Steiermark,330,99,53.5
3666,2413237,2021-04-02,116,30,153,31,7,Tirol,146,61,49.2
3667,1341643,2021-04-02,23,1,117,66,8,Vorarlberg,24,67,1.5
3668,5025512,2021-04-02,509,216,268,148,9,Wien,725,364,59.3
3669,24086423,2021-04-02,1753,537,2237,515,10,Alle,2290,1052,51.0
3670,1002217,2021-04-03,55,20,124,15,1,Burgenland,75,35,57.1
3671,1022572,2021-04-03,69,14,193,26,2,Kärnten,83,40,35.0
3672,5559735,2021-04-03,317,121,703,95,3,Niederösterreich,438,216,56.0
3673,3492403,2021-04-03,233,68,317,63,4,Oberösterreich,301,131,51.9
3674,1461084,2021-04-03,90,20,129,32,5,Salzburg,110,52,38.5
3675,2974104,2021-04-03,256,55,274,43,6,Steiermark,311,98,56.1
3676,2432393,2021-04-03,119,28,150,33,7,Tirol,147,61,45.9
3677,1377060,2021-04-03,25,1,114,66,8,Vorarlberg,26,67,1.5
3678,5081347,2021-04-03,491,206,286,158,9,Wien,697,364,56.6
3679,24402915,2021-04-03,1655,533,2290,531,10,Alle,2188,1064,50.1
3680,1008849,2021-04-04,61,21,121,14,1,Burgenland,82,35,60.0
3681,1023272,2021-04-04,69,13,193,27,2,Kärnten,82,40,32.5
3682,5627205,2021-04-04,332,121,688,92,3,Niederösterreich,453,213,56.8
3683,3528840,2021-04-04,225,71,325,60,4,Oberösterreich,296,131,54.2
3684,1475805,2021-04-04,85,20,134,32,5,Salzburg,105,52,38.5
3685,2994313,2021-04-04,266,60,274,38,6,Steiermark,326,98,61.2
3686,2452467,2021-04-04,120,30,144,31,7,Tirol,150,61,49.2
3687,1404146,2021-04-04,25,3,114,64,8,Vorarlberg,28,67,4.5
3688,5132574,2021-04-04,488,223,289,141,9,Wien,711,364,61.3
3689,24647471,2021-04-04,1671,562,2282,499,10,Alle,2233,1061,53.0
3690,1013451,2021-04-05,62,21,119,14,1,Burgenland,83,35,60.0
3691,1023928,2021-04-05,77,13,184,28,2,Kärnten,90,41,31.7
3692,5667003,2021-04-05,347,123,673,85,3,Niederösterreich,470,208,59.1
3693,3554759,2021-04-05,245,70,305,61,4,Oberösterreich,315,131,53.4
3694,1477274,2021-04-05,91,22,128,30,5,Salzburg,113,52,42.3
3695,2995783,2021-04-05,281,61,258,38,6,Steiermark,342,99,61.6
3696,2470439,2021-04-05,121,33,144,29,7,Tirol,154,62,53.2
3697,1407607,2021-04-05,25,3,117,64,8,Vorarlberg,28,67,4.5
3698,5169561,2021-04-05,522,224,255,140,9,Wien,746,364,61.5
3699,24779805,2021-04-05,1771,570,2183,489,10,Alle,2341,1059,53.8
3700,1022796,2021-04-06,71,20,136,15,1,Burgenland,91,35,57.1
3701,1024436,2021-04-06,82,13,179,28,2,Kärnten,95,41,31.7
3702,5724746,2021-04-06,361,120,659,97,3,Niederösterreich,481,217,55.3
3703,3596428,2021-04-06,255,73,295,58,4,Oberösterreich,328,131,55.7
3704,1488972,2021-04-06,94,23,125,29,5,Salzburg,117,52,44.2
3705,3020536,2021-04-06,291,65,248,35,6,Steiermark,356,100,65.0
3706,2491656,2021-04-06,121,30,149,32,7,Tirol,151,62,48.4
3707,1426164,2021-04-06,29,6,114,62,8,Vorarlberg,35,68,8.8
3708,5203615,2021-04-06,550,233,227,131,9,Wien,783,364,64.0
3709,24999349,2021-04-06,1854,583,2132,487,10,Alle,2437,1070,54.5
3710,1033403,2021-04-07,68,25,132,10,1,Burgenland,93,35,71.4
3711,1038815,2021-04-07,75,17,186,25,2,Kärnten,92,42,40.5
3712,5801219,2021-04-07,394,126,626,88,3,Niederösterreich,520,214,58.9
3713,3656302,2021-04-07,259,72,291,59,4,Oberösterreich,331,131,55.0
3714,1530422,2021-04-07,90,22,129,30,5,Salzburg,112,52,42.3
3715,3091240,2021-04-07,299,63,240,38,6,Steiermark,362,101,62.4
3716,2650259,2021-04-07,126,30,153,32,7,Tirol,156,62,48.4
3717,1458976,2021-04-07,25,7,117,62,8,Vorarlberg,32,69,10.1
3718,5255361,2021-04-07,541,221,236,143,9,Wien,762,364,60.7
3719,25515997,2021-04-07,1877,583,2110,487,10,Alle,2460,1070,54.5
3720,1047236,2021-04-08,66,26,132,9,1,Burgenland,92,35,74.3
3721,1072569,2021-04-08,73,15,189,27,2,Kärnten,88,42,35.7
3722,5879319,2021-04-08,377,123,643,75,3,Niederösterreich,500,198,62.1
3723,3723290,2021-04-08,246,70,304,61,4,Oberösterreich,316,131,53.4
3724,1552358,2021-04-08,87,22,133,30,5,Salzburg,109,52,42.3
3725,3125254,2021-04-08,284,62,254,39,6,Steiermark,346,101,61.4
3726,2665899,2021-04-08,114,31,163,29,7,Tirol,145,60,51.7
3727,1482416,2021-04-08,26,7,116,62,8,Vorarlberg,33,69,10.1
3728,5320157,2021-04-08,534,223,243,141,9,Wien,757,364,61.3
3729,25868498,2021-04-08,1807,579,2177,473,10,Alle,2386,1052,55.0
3730,1056992,2021-04-09,69,24,135,11,1,Burgenland,93,35,68.6
3731,1073542,2021-04-09,78,16,185,27,2,Kärnten,94,43,37.2
3732,5950688,2021-04-09,371,121,649,89,3,Niederösterreich,492,210,57.6
3733,3777942,2021-04-09,253,67,297,64,4,Oberösterreich,320,131,51.1
3734,1574675,2021-04-09,80,25,139,27,5,Salzburg,105,52,48.1
3735,3155878,2021-04-09,278,60,257,41,6,Steiermark,338,101,59.4
3736,2680352,2021-04-09,112,34,160,27,7,Tirol,146,61,55.7
3737,1506813,2021-04-09,25,9,117,62,8,Vorarlberg,34,71,12.7
3738,5384956,2021-04-09,536,226,241,138,9,Wien,762,364,62.1
3739,26161838,2021-04-09,1802,582,2180,486,10,Alle,2384,1068,54.5
3740,1074010,2021-04-10,58,23,115,12,1,Burgenland,81,35,65.7
3741,1074447,2021-04-10,78,14,185,27,2,Kärnten,92,41,34.1
3742,6031253,2021-04-10,370,120,650,86,3,Niederösterreich,490,206,58.3
3743,3815087,2021-04-10,236,66,314,65,4,Oberösterreich,302,131,50.4
3744,1599158,2021-04-10,85,25,135,27,5,Salzburg,110,52,48.1
3745,3192321,2021-04-10,254,58,281,44,6,Steiermark,312,102,56.9
3746,2696118,2021-04-10,103,35,161,37,7,Tirol,138,72,48.6
3747,1541976,2021-04-10,26,8,116,62,8,Vorarlberg,34,70,11.4
3748,5453864,2021-04-10,524,235,253,129,9,Wien,759,364,64.6
3749,26478234,2021-04-10,1734,584,2210,489,10,Alle,2318,1073,54.4
3750,1080084,2021-04-11,65,22,114,13,1,Burgenland,87,35,62.9
3751,1075064,2021-04-11,80,14,183,27,2,Kärnten,94,41,34.1
3752,6091597,2021-04-11,359,125,661,82,3,Niederösterreich,484,207,60.4
3753,3838614,2021-04-11,231,68,319,63,4,Oberösterreich,299,131,51.9
3754,1609352,2021-04-11,80,25,139,27,5,Salzburg,105,52,48.1
3755,3218761,2021-04-11,252,59,283,44,6,Steiermark,311,103,57.3
3756,2710948,2021-04-11,105,32,173,32,7,Tirol,137,64,50.0
3757,1561244,2021-04-11,24,11,117,62,8,Vorarlberg,35,73,15.1
3758,5493411,2021-04-11,509,243,268,121,9,Wien,752,364,66.8
3759,26679075,2021-04-11,1705,599,2257,471,10,Alle,2304,1070,56.0
3760,1088980,2021-04-12,64,21,113,14,1,Burgenland,85,35,60.0
3761,1075839,2021-04-12,79,13,184,27,2,Kärnten,92,40,32.5
3762,6150105,2021-04-12,360,132,660,82,3,Niederösterreich,492,214,61.7
3763,3867780,2021-04-12,249,73,301,58,4,Oberösterreich,322,131,55.7
3764,1610352,2021-04-12,83,27,136,25,5,Salzburg,110,52,51.9
3765,3219891,2021-04-12,299,61,236,41,6,Steiermark,360,102,59.8
3766,2730185,2021-04-12,104,33,158,29,7,Tirol,137,62,53.2
3767,1570346,2021-04-12,28,10,114,62,8,Vorarlberg,38,72,13.9
3768,5535105,2021-04-12,533,245,244,119,9,Wien,778,364,67.3
3769,26848583,2021-04-12,1799,615,2146,457,10,Alle,2414,1072,57.4
3770,1103951,2021-04-13,58,27,117,8,1,Burgenland,85,35,77.1
3771,1078270,2021-04-13,70,13,193,28,2,Kärnten,83,41,31.7
3772,6231831,2021-04-13,364,132,656,68,3,Niederösterreich,496,200,66.0
3773,3919154,2021-04-13,224,74,326,57,4,Oberösterreich,298,131,56.5
3774,1643547,2021-04-13,75,25,144,27,5,Salzburg,100,52,48.1
3775,3268387,2021-04-13,281,56,258,45,6,Steiermark,337,101,55.4
3776,2745213,2021-04-13,100,31,162,32,7,Tirol,131,63,49.2
3777,1595090,2021-04-13,29,9,113,62,8,Vorarlberg,38,71,12.7
3778,5612418,2021-04-13,551,229,226,135,9,Wien,780,364,62.9
3779,27197861,2021-04-13,1752,596,2195,462,10,Alle,2348,1058,56.3
3780,1114375,2021-04-14,51,28,123,7,1,Burgenland,79,35,80.0
3781,1133191,2021-04-14,71,14,192,27,2,Kärnten,85,41,34.1
3782,6293966,2021-04-14,333,127,687,72,3,Niederösterreich,460,199,63.8
3783,3956051,2021-04-14,227,70,323,61,4,Oberösterreich,297,131,53.4
3784,1661810,2021-04-14,74,23,145,27,5,Salzburg,97,50,46.0
3785,3323246,2021-04-14,276,57,263,43,6,Steiermark,333,100,57.0
3786,2915780,2021-04-14,96,36,165,25,7,Tirol,132,61,59.0
3787,1615633,2021-04-14,24,11,118,62,8,Vorarlberg,35,73,15.1
3788,5689086,2021-04-14,535,223,242,141,9,Wien,758,364,61.3
3789,27703138,2021-04-14,1687,589,2258,465,10,Alle,2276,1054,55.9
3790,1124722,2021-04-15,51,26,122,9,1,Burgenland,77,35,74.3
3791,1134988,2021-04-15,74,15,190,26,2,Kärnten,89,41,36.6
3792,6372472,2021-04-15,326,123,694,71,3,Niederösterreich,449,194,63.4
3793,4017569,2021-04-15,208,64,342,67,4,Oberösterreich,272,131,48.9
3794,1680364,2021-04-15,71,20,148,31,5,Salzburg,91,51,39.2
3795,3350944,2021-04-15,240,55,297,44,6,Steiermark,295,99,55.6
3796,2930215,2021-04-15,96,37,163,26,7,Tirol,133,63,58.7
3797,1638246,2021-04-15,23,10,119,62,8,Vorarlberg,33,72,13.9
3798,5762561,2021-04-15,497,221,280,143,9,Wien,718,364,60.7
3799,28012081,2021-04-15,1586,571,2355,479,10,Alle,2157,1050,54.4
3800,1137008,2021-04-16,43,26,136,9,1,Burgenland,69,35,74.3
3801,1136054,2021-04-16,69,15,198,27,2,Kärnten,84,42,35.7
3802,6442862,2021-04-16,316,126,704,71,3,Niederösterreich,442,197,64.0
3803,4048640,2021-04-16,201,64,349,67,4,Oberösterreich,265,131,48.9
3804,1698584,2021-04-16,70,20,132,31,5,Salzburg,90,51,39.2
3805,3378556,2021-04-16,234,56,316,43,6,Steiermark,290,99,56.6
3806,2944140,2021-04-16,97,38,165,27,7,Tirol,135,65,58.5
3807,1661149,2021-04-16,20,9,122,62,8,Vorarlberg,29,71,12.7
3808,5851627,2021-04-16,500,206,277,158,9,Wien,706,364,56.6
3809,28298620,2021-04-16,1550,560,2399,495,10,Alle,2110,1055,53.1
3810,1154895,2021-04-17,37,26,137,9,1,Burgenland,63,35,74.3
3811,1137011,2021-04-17,68,15,197,27,2,Kärnten,83,42,35.7
3812,6520787,2021-04-17,305,124,715,77,3,Niederösterreich,429,201,61.7
3813,4084120,2021-04-17,196,66,354,65,4,Oberösterreich,262,131,50.4
3814,1720004,2021-04-17,69,22,98,29,5,Salzburg,91,51,43.1
3815,3416045,2021-04-17,228,57,323,44,6,Steiermark,285,101,56.4
3816,2959494,2021-04-17,87,36,171,25,7,Tirol,123,61,59.0
3817,1696208,2021-04-17,18,9,124,62,8,Vorarlberg,27,71,12.7
3818,5927405,2021-04-17,499,194,278,170,9,Wien,693,364,53.3
3819,28615969,2021-04-17,1507,549,2397,508,10,Alle,2056,1057,51.9
3820,1163700,2021-04-18,38,25,141,10,1,Burgenland,63,35,71.4
3821,1137889,2021-04-18,69,12,198,30,2,Kärnten,81,42,28.6
3822,6575467,2021-04-18,296,123,724,96,3,Niederösterreich,419,219,56.2
3823,4105264,2021-04-18,204,67,346,64,4,Oberösterreich,271,131,51.1
3824,1730191,2021-04-18,75,24,92,27,5,Salzburg,99,51,47.1
3825,3441078,2021-04-18,233,55,311,47,6,Steiermark,288,102,53.9
3826,2972051,2021-04-18,85,37,176,25,7,Tirol,122,62,59.7
3827,1714868,2021-04-18,19,9,123,62,8,Vorarlberg,28,71,12.7
3828,5983389,2021-04-18,456,194,321,170,9,Wien,650,364,53.3
3829,28823897,2021-04-18,1475,546,2432,531,10,Alle,2021,1077,50.7
3830,1171788,2021-04-19,41,26,138,9,1,Burgenland,67,35,74.3
3831,1138933,2021-04-19,65,17,201,27,2,Kärnten,82,44,38.6
3832,6650205,2021-04-19,324,117,696,93,3,Niederösterreich,441,210,55.7
3833,4134116,2021-04-19,210,70,340,61,4,Oberösterreich,280,131,53.4
3834,1731233,2021-04-19,73,23,129,28,5,Salzburg,96,51,45.1
3835,3442908,2021-04-19,252,51,276,51,6,Steiermark,303,102,50.0
3836,2988916,2021-04-19,89,39,170,26,7,Tirol,128,65,60.0
3837,1723374,2021-04-19,23,10,119,62,8,Vorarlberg,33,72,13.9
3838,6033077,2021-04-19,477,215,300,149,9,Wien,692,364,59.1
3839,29014550,2021-04-19,1554,568,2369,506,10,Alle,2122,1074,52.9
3840,1189714,2021-04-20,43,24,137,11,1,Burgenland,67,35,68.6
3841,1139991,2021-04-20,59,18,205,26,2,Kärnten,77,44,40.9
3842,6730991,2021-04-20,318,118,702,85,3,Niederösterreich,436,203,58.1
3843,4185277,2021-04-20,198,67,352,64,4,Oberösterreich,265,131,51.1
3844,1761166,2021-04-20,74,22,128,28,5,Salzburg,96,50,44.0
3845,3479116,2021-04-20,238,51,295,49,6,Steiermark,289,100,51.0
3846,3003253,2021-04-20,84,38,179,27,7,Tirol,122,65,58.5
3847,1749147,2021-04-20,26,12,116,62,8,Vorarlberg,38,74,16.2
3848,6096511,2021-04-20,491,211,286,153,9,Wien,702,364,58.0
3849,29335166,2021-04-20,1531,561,2400,505,10,Alle,2092,1066,52.6
3850,1202809,2021-04-21,37,25,137,10,1,Burgenland,62,35,71.4
3851,1202792,2021-04-21,60,19,204,24,2,Kärnten,79,43,44.2
3852,6790389,2021-04-21,302,116,718,69,3,Niederösterreich,418,185,62.7
3853,4240167,2021-04-21,186,64,364,67,4,Oberösterreich,250,131,48.9
3854,1518728,2021-04-21,68,19,134,32,5,Salzburg,87,51,37.3
3855,3564343,2021-04-21,226,48,304,51,6,Steiermark,274,99,48.5
3856,3129479,2021-04-21,73,37,160,27,7,Tirol,110,64,57.8
3857,1773612,2021-04-21,22,14,120,62,8,Vorarlberg,36,76,18.4
3858,6175290,2021-04-21,443,209,334,155,9,Wien,652,364,57.4
3859,29597609,2021-04-21,1417,551,2475,497,10,Alle,1968,1048,52.6
3860,1214446,2021-04-22,37,25,141,10,1,Burgenland,62,35,71.4
3861,1204349,2021-04-22,56,19,207,23,2,Kärnten,75,42,45.2
3862,6876060,2021-04-22,284,113,736,72,3,Niederösterreich,397,185,61.1
3863,4293292,2021-04-22,197,61,353,70,4,Oberösterreich,258,131,46.6
3864,1532902,2021-04-22,65,19,137,32,5,Salzburg,84,51,37.3
3865,3598517,2021-04-22,214,45,311,54,6,Steiermark,259,99,45.5
3866,3142482,2021-04-22,74,34,162,31,7,Tirol,108,65,52.3
3867,1798832,2021-04-22,27,11,115,55,8,Vorarlberg,38,66,16.7
3868,6244690,2021-04-22,449,194,328,170,9,Wien,643,364,53.3
3869,29905570,2021-04-22,1403,521,2490,517,10,Alle,1924,1038,50.2
3870,1231480,2021-04-23,34,26,144,9,1,Burgenland,60,35,74.3
3871,1205413,2021-04-23,49,17,214,26,2,Kärnten,66,43,39.5
3872,6935793,2021-04-23,275,114,745,79,3,Niederösterreich,389,193,59.1
3873,4327249,2021-04-23,177,62,373,69,4,Oberösterreich,239,131,47.3
3874,1546930,2021-04-23,61,20,141,32,5,Salzburg,81,52,38.5
3875,3631516,2021-04-23,231,45,299,54,6,Steiermark,276,99,45.5
3876,3156998,2021-04-23,72,33,175,32,7,Tirol,105,65,50.8
3877,1825998,2021-04-23,30,10,112,55,8,Vorarlberg,40,65,15.4
3878,6325084,2021-04-23,427,191,350,173,9,Wien,618,364,52.5
3879,30186461,2021-04-23,1356,518,2553,529,10,Alle,1874,1047,49.5
3880,1248424,2021-04-24,34,26,132,9,1,Burgenland,60,35,74.3
3881,1206460,2021-04-24,45,18,218,25,2,Kärnten,63,43,41.9
3882,7012894,2021-04-24,259,111,761,90,3,Niederösterreich,370,201,55.2
3883,4361230,2021-04-24,163,64,387,67,4,Oberösterreich,227,131,48.9
3884,1564143,2021-04-24,52,20,126,32,5,Salzburg,72,52,38.5
3885,3668920,2021-04-24,215,45,316,55,6,Steiermark,260,100,45.0
3886,3172521,2021-04-24,68,34,183,29,7,Tirol,102,63,54.0
3887,1862837,2021-04-24,28,8,114,57,8,Vorarlberg,36,65,12.3
3888,6391625,2021-04-24,445,182,332,182,9,Wien,627,364,50.0
3889,30489054,2021-04-24,1309,508,2569,546,10,Alle,1817,1054,48.2
3890,1254623,2021-04-25,33,25,130,10,1,Burgenland,58,35,71.4
3891,1207518,2021-04-25,56,19,207,25,2,Kärnten,75,44,43.2
3892,7058283,2021-04-25,246,111,774,92,3,Niederösterreich,357,203,54.7
3893,4381457,2021-04-25,167,65,383,66,4,Oberösterreich,232,131,49.6
3894,1572482,2021-04-25,56,17,146,35,5,Salzburg,73,52,32.7
3895,3693524,2021-04-25,223,49,308,51,6,Steiermark,272,100,49.0
3896,3184728,2021-04-25,72,33,181,32,7,Tirol,105,65,50.8
3897,1883502,2021-04-25,28,7,115,58,8,Vorarlberg,35,65,10.8
3898,6452495,2021-04-25,398,195,379,169,9,Wien,593,364,53.6
3899,30688612,2021-04-25,1279,521,2623,538,10,Alle,1800,1059,49.2
3900,1263842,2021-04-26,38,24,125,11,1,Burgenland,62,35,68.6
3901,1208264,2021-04-26,62,20,202,24,2,Kärnten,82,44,45.5
3902,7094047,2021-04-26,246,115,774,94,3,Niederösterreich,361,209,55.0
3903,4409268,2021-04-26,179,67,371,64,4,Oberösterreich,246,131,51.1
3904,1573674,2021-04-26,58,19,144,33,5,Salzburg,77,52,36.5
3905,3695653,2021-04-26,239,52,293,51,6,Steiermark,291,103,50.5
3906,3201879,2021-04-26,74,32,174,33,7,Tirol,106,65,49.2
3907,1895824,2021-04-26,29,8,113,58,8,Vorarlberg,37,66,12.1
3908,6493900,2021-04-26,408,183,369,181,9,Wien,591,364,50.3
3909,30836351,2021-04-26,1333,520,2565,549,10,Alle,1853,1069,48.6
3910,1276822,2021-04-27,39,21,127,14,1,Burgenland,60,35,60.0
3911,1208866,2021-04-27,52,22,212,22,2,Kärnten,74,44,50.0
3912,7154029,2021-04-27,265,110,755,72,3,Niederösterreich,375,182,60.4
3913,4459169,2021-04-27,179,67,371,64,4,Oberösterreich,246,131,51.1
3914,1600367,2021-04-27,60,19,142,34,5,Salzburg,79,53,35.8
3915,3750005,2021-04-27,249,55,282,47,6,Steiermark,304,102,53.9
3916,3328477,2021-04-27,76,33,168,32,7,Tirol,109,65,50.8
3917,1924083,2021-04-27,29,8,113,59,8,Vorarlberg,37,67,11.9
3918,6561234,2021-04-27,443,186,334,178,9,Wien,629,364,51.1
3919,31263052,2021-04-27,1392,521,2504,522,10,Alle,1913,1043,50.0
3920,1291681,2021-04-28,40,21,150,14,1,Burgenland,61,35,60.0
3921,1161128,2021-04-28,42,16,221,25,2,Kärnten,58,41,39.0
3922,7208320,2021-04-28,241,107,779,78,3,Niederösterreich,348,185,57.8
3923,4389973,2021-04-28,162,64,388,67,4,Oberösterreich,226,131,48.9
3924,1613703,2021-04-28,63,21,139,31,5,Salzburg,84,52,40.4
3925,3708703,2021-04-28,239,57,293,46,6,Steiermark,296,103,55.3
3926,3340308,2021-04-28,71,32,170,31,7,Tirol,103,63,50.8
3927,1950206,2021-04-28,28,8,115,59,8,Vorarlberg,36,67,11.9
3928,6653687,2021-04-28,384,193,393,171,9,Wien,577,364,53.0
3929,31317709,2021-04-28,1270,519,2648,522,10,Alle,1789,1041,49.9
3930,1300878,2021-04-29,33,19,137,16,1,Burgenland,52,35,54.3
3931,1164016,2021-04-29,47,13,218,27,2,Kärnten,60,40,32.5
3932,7268736,2021-04-29,226,102,794,83,3,Niederösterreich,328,185,55.1
3933,4444219,2021-04-29,153,62,397,69,4,Oberösterreich,215,131,47.3
3934,1628525,2021-04-29,70,19,132,33,5,Salzburg,89,52,36.5
3935,3742240,2021-04-29,248,54,284,48,6,Steiermark,302,102,52.9
3936,3361451,2021-04-29,72,30,176,32,7,Tirol,102,62,48.4
3937,1976810,2021-04-29,27,9,116,57,8,Vorarlberg,36,66,13.6
3938,6702849,2021-04-29,357,181,420,183,9,Wien,538,364,49.7
3939,31589724,2021-04-29,1233,489,2674,548,10,Alle,1722,1037,47.2
3940,1316161,2021-04-30,29,18,145,17,1,Burgenland,47,35,51.4
3941,1166943,2021-04-30,45,20,221,41,2,Kärnten,65,61,32.8
3942,7308464,2021-04-30,211,102,809,85,3,Niederösterreich,313,187,54.5
3943,4477521,2021-04-30,143,63,407,68,4,Oberösterreich,206,131,48.1
3944,1645400,2021-04-30,69,22,139,30,5,Salzburg,91,52,42.3
3945,3778686,2021-04-30,231,50,301,51,6,Steiermark,281,101,49.5
3946,3374877,2021-04-30,75,29,166,32,7,Tirol,104,61,47.5
3947,2004875,2021-04-30,27,10,115,56,8,Vorarlberg,37,66,15.2
3948,6819977,2021-04-30,324,192,453,172,9,Wien,516,364,52.7
3949,31892904,2021-04-30,1154,506,2756,552,10,Alle,1660,1058,47.8
3950,1339910,2021-05-01,22,18,153,17,1,Burgenland,40,35,51.4
3951,1197118,2021-05-01,42,8,224,53,2,Kärnten,50,61,13.1
3952,7373844,2021-05-01,199,95,821,88,3,Niederösterreich,294,183,51.9
3953,4510075,2021-05-01,147,62,403,69,4,Oberösterreich,209,131,47.3
3954,1665986,2021-05-01,62,19,141,33,5,Salzburg,81,52,36.5
3955,3817717,2021-05-01,210,53,322,48,6,Steiermark,263,101,52.5
3956,3388931,2021-05-01,71,27,172,29,7,Tirol,98,56,48.2
3957,2043302,2021-05-01,27,10,115,56,8,Vorarlberg,37,66,15.2
3958,6891523,2021-05-01,301,190,476,174,9,Wien,491,364,52.2
3959,32228406,2021-05-01,1081,482,2827,567,10,Alle,1563,1049,45.9
3960,1345076,2021-05-02,28,19,151,12,1,Burgenland,47,31,61.3
3961,1197990,2021-05-02,49,8,217,53,2,Kärnten,57,61,13.1
3962,7405558,2021-05-02,195,93,825,97,3,Niederösterreich,288,190,48.9
3963,4525493,2021-05-02,149,64,401,67,4,Oberösterreich,213,131,48.9
3964,1676569,2021-05-02,59,19,141,33,5,Salzburg,78,52,36.5
3965,3831785,2021-05-02,206,52,328,49,6,Steiermark,258,101,51.5
3966,3400214,2021-05-02,69,27,172,27,7,Tirol,96,54,50.0
3967,2063720,2021-05-02,33,10,109,58,8,Vorarlberg,43,68,14.7
3968,6937569,2021-05-02,299,184,478,180,9,Wien,483,364,50.5
3969,32383974,2021-05-02,1087,476,2822,576,10,Alle,1563,1052,45.2
3970,1352004,2021-05-03,28,19,151,12,1,Burgenland,47,31,61.3
3971,1198413,2021-05-03,49,19,216,42,2,Kärnten,68,61,31.1
3972,7446666,2021-05-03,206,93,814,101,3,Niederösterreich,299,194,47.9
3973,4553813,2021-05-03,156,63,394,68,4,Oberösterreich,219,131,48.1
3974,1678692,2021-05-03,57,20,145,32,5,Salzburg,77,52,38.5
3975,3834070,2021-05-03,219,51,315,53,6,Steiermark,270,104,49.0
3976,3418004,2021-05-03,71,27,167,30,7,Tirol,98,57,47.4
3977,2076646,2021-05-03,42,10,100,58,8,Vorarlberg,52,68,14.7
3978,6937569,2021-05-03,311,183,466,181,9,Wien,494,364,50.3
3979,32495877,2021-05-03,1139,485,2768,577,10,Alle,1624,1062,45.7
3980,1369564,2021-05-04,23,17,153,18,1,Burgenland,40,35,48.6
3981,1199456,2021-05-04,49,19,218,42,2,Kärnten,68,61,31.1
3982,7496161,2021-05-04,221,88,799,83,3,Niederösterreich,309,171,51.5
3983,4617613,2021-05-04,155,60,395,71,4,Oberösterreich,215,131,45.8
3984,1710527,2021-05-04,58,19,144,33,5,Salzburg,77,52,36.5
3985,3890389,2021-05-04,219,49,310,53,6,Steiermark,268,102,48.0
3986,3430976,2021-05-04,72,26,168,25,7,Tirol,98,51,51.0
3987,2105596,2021-05-04,51,8,91,59,8,Vorarlberg,59,67,11.9
3988,7075011,2021-05-04,307,177,470,187,9,Wien,484,364,48.6
3989,32895293,2021-05-04,1155,463,2748,571,10,Alle,1618,1034,44.8
3990,1381715,2021-05-05,21,17,155,18,1,Burgenland,38,35,48.6
3991,1224469,2021-05-05,46,8,219,44,2,Kärnten,54,52,15.4
3992,7562753,2021-05-05,204,86,816,65,3,Niederösterreich,290,151,57.0
3993,4652977,2021-05-05,154,61,396,70,4,Oberösterreich,215,131,46.6
3994,1725579,2021-05-05,52,20,150,32,5,Salzburg,72,52,38.5
3995,3943277,2021-05-05,221,43,309,58,6,Steiermark,264,101,42.6
3996,3444450,2021-05-05,72,24,159,27,7,Tirol,96,51,47.1
3997,2131720,2021-05-05,48,8,94,59,8,Vorarlberg,56,67,11.9
3998,7175992,2021-05-05,289,173,488,191,9,Wien,462,364,47.5
3999,33242932,2021-05-05,1107,440,2786,564,10,Alle,1547,1004,43.8
4000,1393362,2021-05-06,19,17,158,18,1,Burgenland,36,35,48.6
4001,1225046,2021-05-06,42,10,223,42,2,Kärnten,52,52,19.2
4002,7634765,2021-05-06,192,79,828,75,3,Niederösterreich,271,154,51.3
4003,4706863,2021-05-06,135,63,415,68,4,Oberösterreich,198,131,48.1
4004,1743147,2021-05-06,53,17,149,33,5,Salzburg,70,50,34.0
4005,3978238,2021-05-06,202,44,325,58,6,Steiermark,246,102,43.1
4006,3585669,2021-05-06,63,23,173,28,7,Tirol,86,51,45.1
4007,2158163,2021-05-06,42,9,100,58,8,Vorarlberg,51,67,13.4
4008,7277006,2021-05-06,269,169,508,195,9,Wien,438,364,46.4
4009,33702259,2021-05-06,1017,431,2879,575,10,Alle,1448,1006,42.8
4010,1406623,2021-05-07,17,17,162,18,1,Burgenland,34,35,48.6
4011,1225824,2021-05-07,36,10,229,43,2,Kärnten,46,53,18.9
4012,7695901,2021-05-07,172,82,848,74,3,Niederösterreich,254,156,52.6
4013,4739112,2021-05-07,128,65,422,66,4,Oberösterreich,193,131,49.6
4014,1757951,2021-05-07,55,18,147,34,5,Salzburg,73,52,34.6
4015,4011351,2021-05-07,187,43,342,57,6,Steiermark,230,100,43.0
4016,3601073,2021-05-07,60,28,184,25,7,Tirol,88,53,52.8
4017,2185984,2021-05-07,40,9,102,59,8,Vorarlberg,49,68,13.2
4018,7366369,2021-05-07,264,150,513,214,9,Wien,414,364,41.2
4019,33990188,2021-05-07,959,422,2949,590,10,Alle,1381,1012,41.7
4020,1424333,2021-05-08,14,16,166,19,1,Burgenland,30,35,45.7
4021,1226748,2021-05-08,39,9,229,43,2,Kärnten,48,52,17.3
4022,7760621,2021-05-08,167,81,853,88,3,Niederösterreich,248,169,47.9
4023,4773735,2021-05-08,112,61,438,70,4,Oberösterreich,173,131,46.6
4024,1779423,2021-05-08,50,18,152,34,5,Salzburg,68,52,34.6
4025,4051628,2021-05-08,172,42,357,58,6,Steiermark,214,100,42.0
4026,3613854,2021-05-08,55,27,174,24,7,Tirol,82,51,52.9
4027,2226116,2021-05-08,33,8,109,62,8,Vorarlberg,41,70,11.4
4028,7443504,2021-05-08,244,144,533,220,9,Wien,388,364,39.6
4029,34299962,2021-05-08,886,406,3011,618,10,Alle,1292,1024,39.6
4030,1431182,2021-05-09,13,16,166,19,1,Burgenland,29,35,45.7
4031,1227262,2021-05-09,40,9,228,43,2,Kärnten,49,52,17.3
4032,7804041,2021-05-09,154,74,866,87,3,Niederösterreich,228,161,46.0
4033,4794344,2021-05-09,110,63,440,68,4,Oberösterreich,173,131,48.1
4034,1790871,2021-05-09,48,16,154,36,5,Salzburg,64,52,30.8
4035,4076337,2021-05-09,180,42,349,58,6,Steiermark,222,100,42.0
4036,3623459,2021-05-09,54,29,169,27,7,Tirol,83,56,51.8
4037,2250566,2021-05-09,31,9,113,62,8,Vorarlberg,40,71,12.7
4038,7506115,2021-05-09,235,151,542,213,9,Wien,386,364,41.5
4039,34504177,2021-05-09,865,409,3027,613,10,Alle,1274,1022,40.0
4040,1439691,2021-05-10,13,16,165,18,1,Burgenland,29,34,47.1
4041,1227666,2021-05-10,33,10,231,44,2,Kärnten,43,54,18.5
4042,7837987,2021-05-10,155,72,865,85,3,Niederösterreich,227,157,45.9
4043,4818439,2021-05-10,111,60,339,71,4,Oberösterreich,171,131,45.8
4044,1794193,2021-05-10,41,19,161,33,5,Salzburg,60,52,36.5
4045,4078199,2021-05-10,184,40,346,63,6,Steiermark,224,103,38.8
4046,3636270,2021-05-10,58,29,166,26,7,Tirol,87,55,52.7
4047,2263315,2021-05-10,33,8,112,63,8,Vorarlberg,41,71,11.3
4048,7543873,2021-05-10,235,131,542,233,9,Wien,366,364,36.0
4049,34639633,2021-05-10,863,385,2927,636,10,Alle,1248,1021,37.7
4050,1455545,2021-05-11,11,15,163,20,1,Burgenland,26,35,42.9
4051,1229754,2021-05-11,41,9,219,44,2,Kärnten,50,53,17.0
4052,7907389,2021-05-11,151,67,869,69,3,Niederösterreich,218,136,49.3
4053,4876182,2021-05-11,110,52,340,79,4,Oberösterreich,162,131,39.7
4054,1828764,2021-05-11,47,15,155,37,5,Salzburg,62,52,28.8
4055,4129903,2021-05-11,182,37,347,66,6,Steiermark,219,103,35.9
4056,3646781,2021-05-11,58,29,166,26,7,Tirol,87,55,52.7
4057,2291760,2021-05-11,29,7,113,64,8,Vorarlberg,36,71,9.9
4058,7637152,2021-05-11,228,127,549,237,9,Wien,355,364,34.9
4059,35003230,2021-05-11,857,358,2921,642,10,Alle,1215,1000,35.8
4060,1467008,2021-05-12,10,13,164,22,1,Burgenland,23,35,37.1
4061,1309335,2021-05-12,38,7,221,45,2,Kärnten,45,52,13.5
4062,7966852,2021-05-12,151,62,869,61,3,Niederösterreich,213,123,50.4
4063,4909829,2021-05-12,104,51,346,80,4,Oberösterreich,155,131,38.9
4064,1844034,2021-05-12,40,14,143,36,5,Salzburg,54,50,28.0
4065,4179323,2021-05-12,175,34,352,68,6,Steiermark,209,102,33.3
4066,3657922,2021-05-12,48,28,175,30,7,Tirol,76,58,48.3
4067,2313789,2021-05-12,30,9,112,63,8,Vorarlberg,39,72,12.5
4068,7734926,2021-05-12,201,119,576,245,9,Wien,320,364,32.7
4069,35383018,2021-05-12,797,337,2958,650,10,Alle,1134,987,34.1
4070,1478247,2021-05-13,8,12,165,23,1,Burgenland,20,35,34.3
4071,1311192,2021-05-13,36,4,223,48,2,Kärnten,40,52,7.7
4072,8024719,2021-05-13,122,64,218,68,3,Niederösterreich,186,132,48.5
4073,4959174,2021-05-13,97,46,353,85,4,Oberösterreich,143,131,35.1
4074,1862735,2021-05-13,31,14,152,38,5,Salzburg,45,52,26.9
4075,4219812,2021-05-13,158,34,369,68,6,Steiermark,192,102,33.3
4076,3779126,2021-05-13,41,29,181,25,7,Tirol,70,54,53.7
4077,2341732,2021-05-13,21,10,121,63,8,Vorarlberg,31,73,13.7
4078,7821975,2021-05-13,181,103,596,261,9,Wien,284,364,28.3
4079,35798712,2021-05-13,695,316,2378,679,10,Alle,1011,995,31.8
4080,1486326,2021-05-14,12,9,164,26,1,Burgenland,21,35,25.7
4081,1311813,2021-05-14,41,6,218,46,2,Kärnten,47,52,11.5
4082,8055822,2021-05-14,110,61,230,85,3,Niederösterreich,171,146,41.8
4083,4978489,2021-05-14,99,46,351,85,4,Oberösterreich,145,131,35.1
4084,1870174,2021-05-14,29,14,154,38,5,Salzburg,43,52,26.9
4085,4221618,2021-05-14,168,37,359,63,6,Steiermark,205,100,37.0
4086,3790391,2021-05-14,45,29,182,25,7,Tirol,74,54,53.7
4087,2358960,2021-05-14,20,10,122,63,8,Vorarlberg,30,73,13.7
4088,7866320,2021-05-14,162,110,615,254,9,Wien,272,364,30.2
4089,35939913,2021-05-14,686,322,2395,685,10,Alle,1008,1007,32.0
4090,1504261,2021-05-15,14,8,153,27,1,Burgenland,22,35,22.9
4091,1312408,2021-05-15,29,5,236,47,2,Kärnten,34,52,9.6
4092,8113423,2021-05-15,99,63,241,76,3,Niederösterreich,162,139,45.3
4093,5009678,2021-05-15,77,48,373,83,4,Oberösterreich,125,131,36.6
4094,1889696,2021-05-15,26,16,127,36,5,Salzburg,42,52,30.8
4095,4262577,2021-05-15,147,32,380,66,6,Steiermark,179,98,32.7
4096,3801169,2021-05-15,38,27,194,27,7,Tirol,65,54,50.0
4097,2391484,2021-05-15,14,9,129,64,8,Vorarlberg,23,73,12.3
4098,7932899,2021-05-15,184,107,593,257,9,Wien,291,364,29.4
4099,36217595,2021-05-15,628,315,2426,683,10,Alle,943,998,31.6
4100,1509785,2021-05-16,14,7,157,28,1,Burgenland,21,35,20.0
4101,1312915,2021-05-16,26,3,236,47,2,Kärnten,29,50,6.0
4102,8147830,2021-05-16,101,55,239,86,3,Niederösterreich,156,141,39.0
4103,5026717,2021-05-16,83,43,367,88,4,Oberösterreich,126,131,32.8
4104,1898269,2021-05-16,27,14,126,38,5,Salzburg,41,52,26.9
4105,4285484,2021-05-16,152,28,376,70,6,Steiermark,180,98,28.6
4106,3809353,2021-05-16,40,26,187,26,7,Tirol,66,52,50.0
4107,2410258,2021-05-16,13,9,130,65,8,Vorarlberg,22,74,12.2
4108,7992464,2021-05-16,156,100,621,264,9,Wien,256,364,27.5
4109,36393075,2021-05-16,612,285,2439,712,10,Alle,897,997,28.6
4110,1517991,2021-05-17,14,8,156,27,1,Burgenland,22,35,22.9
4111,1313439,2021-05-17,29,3,226,46,2,Kärnten,32,49,6.1
4112,8178563,2021-05-17,94,57,246,87,3,Niederösterreich,151,144,39.6
4113,5051147,2021-05-17,83,45,367,86,4,Oberösterreich,128,131,34.4
4114,1898993,2021-05-17,28,13,125,39,5,Salzburg,41,52,25.0
4115,4287187,2021-05-17,162,26,366,70,6,Steiermark,188,96,27.1
4116,3822593,2021-05-17,42,25,178,26,7,Tirol,67,51,49.0
4117,2417817,2021-05-17,18,9,124,62,8,Vorarlberg,27,71,12.7
4118,8043717,2021-05-17,154,104,623,260,9,Wien,258,364,28.6
4119,36531447,2021-05-17,624,290,2411,703,10,Alle,914,993,29.2
4120,1533956,2021-05-18,13,8,158,27,1,Burgenland,21,35,22.9
4121,1314141,2021-05-18,33,2,222,46,2,Kärnten,35,48,4.2
4122,8235423,2021-05-18,95,56,245,75,3,Niederösterreich,151,131,42.7
4123,5094728,2021-05-18,74,43,376,88,4,Oberösterreich,117,131,32.8
4124,1927721,2021-05-18,25,13,128,39,5,Salzburg,38,52,25.0
4125,4336839,2021-05-18,146,28,381,69,6,Steiermark,174,97,28.9
4126,3832350,2021-05-18,38,26,181,26,7,Tirol,64,52,50.0
4127,2440424,2021-05-18,19,9,123,61,8,Vorarlberg,28,70,12.9
4128,8125236,2021-05-18,157,93,620,271,9,Wien,250,364,25.5
4129,36840818,2021-05-18,600,278,2434,702,10,Alle,878,980,28.4
4130,1548756,2021-05-19,14,9,152,26,1,Burgenland,23,35,25.7
4131,1350222,2021-05-19,33,1,221,48,2,Kärnten,34,49,2.0
4132,8316175,2021-05-19,87,56,253,70,3,Niederösterreich,143,126,44.4
4133,5136216,2021-05-19,69,43,381,88,4,Oberösterreich,112,131,32.8
4134,1943649,2021-05-19,25,15,114,37,5,Salzburg,40,52,28.8
4135,4399664,2021-05-19,126,26,399,71,6,Steiermark,152,97,26.8
4136,3845363,2021-05-19,34,24,178,28,7,Tirol,58,52,46.2
4137,2458279,2021-05-19,21,6,121,67,8,Vorarlberg,27,73,8.2
4138,8239058,2021-05-19,154,86,623,278,9,Wien,240,364,23.6
4139,37237382,2021-05-19,563,266,2442,713,10,Alle,829,979,27.2
4140,1563307,2021-05-20,10,8,155,27,1,Burgenland,18,35,22.9
4141,1352816,2021-05-20,34,1,221,44,2,Kärnten,35,45,2.2
4142,8400686,2021-05-20,82,55,258,88,3,Niederösterreich,137,143,38.5
4143,5202123,2021-05-20,58,39,450,103,4,Oberösterreich,97,142,27.5
4144,1968147,2021-05-20,21,16,118,36,5,Salzburg,37,52,30.8
4145,4456349,2021-05-20,120,23,405,74,6,Steiermark,143,97,23.7
4146,3862170,2021-05-20,30,24,183,26,7,Tirol,54,50,48.0
4147,2480216,2021-05-20,19,6,123,63,8,Vorarlberg,25,69,8.7
4148,8340220,2021-05-20,144,77,633,287,9,Wien,221,364,21.2
4149,37626034,2021-05-20,518,249,2546,748,10,Alle,767,997,25.0
4150,1574418,2021-05-21,10,8,154,27,1,Burgenland,18,35,22.9
4151,1359493,2021-05-21,34,3,221,42,2,Kärnten,37,45,6.7
4152,8442978,2021-05-21,77,57,263,86,3,Niederösterreich,134,143,39.9
4153,5242055,2021-05-21,54,38,350,103,4,Oberösterreich,92,141,27.0
4154,1987040,2021-05-21,17,16,122,36,5,Salzburg,33,52,30.8
4155,4498321,2021-05-21,113,24,412,74,6,Steiermark,137,98,24.5
4156,3975707,2021-05-21,25,23,186,31,7,Tirol,48,54,42.6
4157,2498381,2021-05-21,14,7,128,63,8,Vorarlberg,21,70,10.0
4158,8471793,2021-05-21,119,58,658,306,9,Wien,177,364,15.9
4159,38050186,2021-05-21,463,234,2494,768,10,Alle,697,1002,23.4
4160,1602084,2021-05-22,9,9,156,26,1,Burgenland,18,35,25.7
4161,1360969,2021-05-22,27,2,221,42,2,Kärnten,29,44,4.5
4162,8558956,2021-05-22,73,53,267,97,3,Niederösterreich,126,150,35.3
4163,5296575,2021-05-22,44,36,306,67,4,Oberösterreich,80,103,35.0
4164,2019534,2021-05-22,18,13,121,39,5,Salzburg,31,52,25.0
4165,4570020,2021-05-22,87,22,438,76,6,Steiermark,109,98,22.4
4166,3993726,2021-05-22,20,22,186,32,7,Tirol,42,54,40.7
4167,2529280,2021-05-22,9,7,133,63,8,Vorarlberg,16,70,10.0
4168,8598393,2021-05-22,119,73,658,291,9,Wien,192,364,20.1
4169,38529537,2021-05-22,406,237,2486,733,10,Alle,643,970,24.4
4170,1614604,2021-05-23,10,9,158,26,1,Burgenland,19,35,25.7
4171,1361273,2021-05-23,23,1,229,46,2,Kärnten,24,47,2.1
4172,8631708,2021-05-23,65,52,275,97,3,Niederösterreich,117,149,34.9
4173,5337719,2021-05-23,44,37,306,66,4,Oberösterreich,81,103,35.9
4174,2042689,2021-05-23,18,13,121,39,5,Salzburg,31,52,25.0
4175,4623087,2021-05-23,86,22,439,76,6,Steiermark,108,98,22.4
4176,4011721,2021-05-23,23,23,187,31,7,Tirol,46,54,42.6
4177,2548467,2021-05-23,9,7,133,63,8,Vorarlberg,16,70,10.0
4178,8706441,2021-05-23,108,73,669,291,9,Wien,181,364,20.1
4179,38877709,2021-05-23,386,237,2517,735,10,Alle,623,972,24.4
4180,1626356,2021-05-24,12,9,156,26,1,Burgenland,21,35,25.7
4181,1361533,2021-05-24,21,1,233,47,2,Kärnten,22,48,2.1
4182,8674411,2021-05-24,65,55,275,96,3,Niederösterreich,120,151,36.4
4183,5369323,2021-05-24,43,39,307,64,4,Oberösterreich,82,103,37.9
4184,2044067,2021-05-24,17,13,122,39,5,Salzburg,30,52,25.0
4185,4642645,2021-05-24,83,16,442,82,6,Steiermark,99,98,16.3
4186,4030998,2021-05-24,23,22,187,33,7,Tirol,45,55,40.0
4187,2556281,2021-05-24,8,7,134,63,8,Vorarlberg,15,70,10.0
4188,8783610,2021-05-24,96,62,681,302,9,Wien,158,364,17.0
4189,39089224,2021-05-24,368,224,2537,752,10,Alle,592,976,23.0
4190,1637958,2021-05-25,10,10,156,25,1,Burgenland,20,35,28.6
4191,1364105,2021-05-25,19,0,235,46,2,Kärnten,19,46,0.0
4192,8727483,2021-05-25,66,54,274,100,3,Niederösterreich,120,154,35.1
4193,5456970,2021-05-25,48,39,302,64,4,Oberösterreich,87,103,37.9
4194,2060793,2021-05-25,15,13,124,39,5,Salzburg,28,52,25.0
4195,4744944,2021-05-25,86,16,439,83,6,Steiermark,102,99,16.2
4196,4050839,2021-05-25,23,23,178,33,7,Tirol,46,56,41.1
4197,2568768,2021-05-25,9,6,134,64,8,Vorarlberg,15,70,8.6
4198,8859658,2021-05-25,107,59,670,305,9,Wien,166,364,16.2
4199,39471518,2021-05-25,383,220,2512,759,10,Alle,603,979,22.5
4200,1653636,2021-05-26,8,8,155,27,1,Burgenland,16,35,22.9
4201,1397311,2021-05-26,15,0,241,46,2,Kärnten,15,46,0.0
4202,8809015,2021-05-26,69,49,271,86,3,Niederösterreich,118,135,36.3
4203,5482943,2021-05-26,45,34,305,69,4,Oberösterreich,79,103,33.0
4204,2105841,2021-05-26,14,11,112,41,5,Salzburg,25,52,21.2
4205,4832028,2021-05-26,62,15,445,82,6,Steiermark,77,97,15.5
4206,4065841,2021-05-26,19,23,205,25,7,Tirol,42,48,47.9
4207,2588098,2021-05-26,13,6,129,62,8,Vorarlberg,19,68,8.8
4208,8979797,2021-05-26,104,52,673,312,9,Wien,156,364,14.3
4209,39914510,2021-05-26,349,198,2536,750,10,Alle,547,948,20.9
4210,1665407,2021-05-27,10,11,152,24,1,Burgenland,21,35,31.4
4211,1465110,2021-05-27,11,0,247,48,2,Kärnten,11,48,0.0
4212,8870648,2021-05-27,67,48,273,87,3,Niederösterreich,115,135,35.6
4213,5563074,2021-05-27,41,32,309,71,4,Oberösterreich,73,103,31.1
4214,2122292,2021-05-27,17,9,109,42,5,Salzburg,26,51,17.6
4215,4904697,2021-05-27,62,9,443,87,6,Steiermark,71,96,9.4
4216,4142109,2021-05-27,19,21,183,27,7,Tirol,40,48,43.8
4217,2603856,2021-05-27,9,6,133,62,8,Vorarlberg,15,68,8.8
4218,9119645,2021-05-27,82,56,695,308,9,Wien,138,364,15.4
4219,40456838,2021-05-27,318,192,2544,756,10,Alle,510,948,20.3
4220,1681489,2021-05-28,9,12,149,24,1,Burgenland,21,36,33.3
4221,1465132,2021-05-28,10,0,235,48,2,Kärnten,10,48,0.0
4222,8927523,2021-05-28,62,44,278,82,3,Niederösterreich,106,126,34.9
4223,5592840,2021-05-28,34,31,216,72,4,Oberösterreich,65,103,30.1
4224,2137210,2021-05-28,15,8,115,44,5,Salzburg,23,52,15.4
4225,4973341,2021-05-28,50,7,454,90,6,Steiermark,57,97,7.2
4226,4155773,2021-05-28,16,19,190,27,7,Tirol,35,46,41.3
4227,2619597,2021-05-28,6,6,136,61,8,Vorarlberg,12,67,9.0
4228,9236221,2021-05-28,83,44,694,320,9,Wien,127,364,12.1
4229,40789126,2021-05-28,285,171,2467,768,10,Alle,456,939,18.2
4230,1704353,2021-05-29,10,12,93,23,1,Burgenland,22,35,34.3
4231,1466702,2021-05-29,9,0,236,48,2,Kärnten,9,48,0.0
4232,9006552,2021-05-29,60,44,280,96,3,Niederösterreich,104,140,31.4
4233,5638147,2021-05-29,30,32,220,71,4,Oberösterreich,62,103,31.1
4234,2181257,2021-05-29,16,7,114,45,5,Salzburg,23,52,13.5
4235,5063656,2021-05-29,43,7,484,90,6,Steiermark,50,97,7.2
4236,4173329,2021-05-29,16,15,189,33,7,Tirol,31,48,31.2
4237,2645775,2021-05-29,7,5,135,63,8,Vorarlberg,12,68,7.4
4238,9344468,2021-05-29,82,41,695,323,9,Wien,123,364,11.3
4239,41224239,2021-05-29,273,163,2446,792,10,Alle,436,955,17.1
4240,1718043,2021-05-30,9,11,95,24,1,Burgenland,20,35,31.4
4241,1466953,2021-05-30,11,0,234,48,2,Kärnten,11,48,0.0
4242,9066796,2021-05-30,52,41,288,108,3,Niederösterreich,93,149,27.5
4243,5638796,2021-05-30,31,31,219,72,4,Oberösterreich,62,103,30.1
4244,2222303,2021-05-30,17,7,112,45,5,Salzburg,24,52,13.5
4245,5132802,2021-05-30,43,6,484,90,6,Steiermark,49,96,6.2
4246,4188903,2021-05-30,18,15,184,33,7,Tirol,33,48,31.2
4247,2660255,2021-05-30,9,4,133,63,8,Vorarlberg,13,67,6.0
4248,9468873,2021-05-30,74,34,703,330,9,Wien,108,364,9.3
4249,41563724,2021-05-30,264,149,2452,813,10,Alle,413,962,15.5
4250,1727866,2021-05-31,10,10,97,25,1,Burgenland,20,35,28.6
4251,1467424,2021-05-31,11,0,239,50,2,Kärnten,11,50,0.0
4252,9104097,2021-05-31,55,41,285,118,3,Niederösterreich,96,159,25.8
4253,5639735,2021-05-31,32,32,218,71,4,Oberösterreich,64,103,31.1
4254,2248912,2021-05-31,16,7,107,45,5,Salzburg,23,52,13.5
4255,5179808,2021-05-31,38,6,473,90,6,Steiermark,44,96,6.2
4256,4206311,2021-05-31,17,15,182,32,7,Tirol,32,47,31.9
4257,2666184,2021-05-31,9,5,133,63,8,Vorarlberg,14,68,7.4
4258,9535872,2021-05-31,70,36,707,328,9,Wien,106,364,9.9
4259,41776209,2021-05-31,258,152,2441,822,10,Alle,410,974,15.6
4260,1743240,2021-06-01,11,9,118,26,1,Burgenland,20,35,25.7
4261,1467836,2021-06-01,29,8,220,50,2,Kärnten,37,58,13.8
4262,9165500,2021-06-01,46,37,294,111,3,Niederösterreich,83,148,25.0
4263,5648327,2021-06-01,33,27,217,76,4,Oberösterreich,60,103,26.2
4264,2292718,2021-06-01,18,7,105,45,5,Salzburg,25,52,13.5
4265,5254136,2021-06-01,38,6,473,90,6,Steiermark,44,96,6.2
4266,4220340,2021-06-01,15,16,178,33,7,Tirol,31,49,32.7
4267,2681953,2021-06-01,8,5,134,61,8,Vorarlberg,13,66,7.6
4268,9648499,2021-06-01,70,32,707,332,9,Wien,102,364,8.8
4269,42122549,2021-06-01,268,147,2446,824,10,Alle,415,971,15.1
4270,1755748,2021-06-02,11,9,103,26,1,Burgenland,20,35,25.7
4271,1513700,2021-06-02,30,7,223,51,2,Kärnten,37,58,12.1
4272,9215471,2021-06-02,48,37,292,107,3,Niederösterreich,85,144,25.7
4273,6186623,2021-06-02,27,25,223,55,4,Oberösterreich,52,80,31.2
4274,2327933,2021-06-02,17,4,106,48,5,Salzburg,21,52,7.7
4275,5334198,2021-06-02,36,5,467,93,6,Steiermark,41,98,5.1
4276,4234223,2021-06-02,16,14,178,36,7,Tirol,30,50,28.0
4277,2693527,2021-06-02,9,5,133,61,8,Vorarlberg,14,66,7.6
4278,9786653,2021-06-02,72,30,705,334,9,Wien,102,364,8.2
4279,43048076,2021-06-02,266,136,2430,811,10,Alle,402,947,14.4
4280,1771077,2021-06-03,12,7,98,28,1,Burgenland,19,35,20.0
4281,1515354,2021-06-03,30,5,219,51,2,Kärnten,35,56,8.9
4282,9296476,2021-06-03,42,36,298,86,3,Niederösterreich,78,122,29.5
4283,6347909,2021-06-03,24,19,226,61,4,Oberösterreich,43,80,23.8
4284,2375279,2021-06-03,13,5,110,47,5,Salzburg,18,52,9.6
4285,5407581,2021-06-03,31,6,472,92,6,Steiermark,37,98,6.1
4286,4381873,2021-06-03,16,14,186,36,7,Tirol,30,50,28.0
4287,2713592,2021-06-03,9,5,133,61,8,Vorarlberg,14,66,7.6
4288,9919962,2021-06-03,68,31,709,333,9,Wien,99,364,8.5
4289,43729103,2021-06-03,245,128,2451,795,10,Alle,373,923,13.9
4290,1796354,2021-06-04,13,7,94,28,1,Burgenland,20,35,20.0
4291,1515535,2021-06-04,29,5,221,51,2,Kärnten,34,56,8.9
4292,9343787,2021-06-04,41,36,299,103,3,Niederösterreich,77,139,25.9
4293,6416222,2021-06-04,26,16,224,64,4,Oberösterreich,42,80,20.0
4294,2415076,2021-06-04,14,1,109,51,5,Salzburg,15,52,1.9
4295,5480189,2021-06-04,32,6,473,92,6,Steiermark,38,98,6.1
4296,4401121,2021-06-04,20,15,183,35,7,Tirol,35,50,30.0
4297,2723752,2021-06-04,9,5,133,61,8,Vorarlberg,14,66,7.6
4298,10018309,2021-06-04,63,24,714,340,9,Wien,87,364,6.6
4299,44110345,2021-06-04,247,115,2450,825,10,Alle,362,940,12.2
4300,1820591,2021-06-05,13,7,94,28,1,Burgenland,20,35,20.0
4301,1621778,2021-06-05,28,5,221,51,2,Kärnten,33,56,8.9
4302,9420683,2021-06-05,41,31,299,103,3,Niederösterreich,72,134,23.1
4303,6600593,2021-06-05,23,17,227,63,4,Oberösterreich,40,80,21.2
4304,2473506,2021-06-05,10,4,113,47,5,Salzburg,14,51,7.8
4305,5608953,2021-06-05,23,6,471,92,6,Steiermark,29,98,6.1
4306,4418730,2021-06-05,17,16,186,34,7,Tirol,33,50,32.0
4307,2744656,2021-06-05,8,5,135,61,8,Vorarlberg,13,66,7.6
4308,10149504,2021-06-05,125,59,652,305,9,Wien,184,364,16.2
4309,44858994,2021-06-05,288,150,2398,784,10,Alle,438,934,16.1
4310,1837099,2021-06-06,9,9,100,26,1,Burgenland,18,35,25.7
4311,1622297,2021-06-06,30,4,221,52,2,Kärnten,34,56,7.1
4312,9471896,2021-06-06,38,30,302,107,3,Niederösterreich,68,137,21.9
4313,6700206,2021-06-06,25,17,225,63,4,Oberösterreich,42,80,21.2
4314,2520970,2021-06-06,11,4,112,49,5,Salzburg,15,53,7.5
4315,5692157,2021-06-06,24,8,471,90,6,Steiermark,32,98,8.2
4316,4436149,2021-06-06,21,16,180,32,7,Tirol,37,48,33.3
4317,2756379,2021-06-06,9,5,133,65,8,Vorarlberg,14,70,7.1
4318,10241226,2021-06-06,117,51,660,313,9,Wien,168,364,14.0
4319,45278379,2021-06-06,284,144,2404,797,10,Alle,428,941,15.3
4320,1850359,2021-06-07,9,9,97,26,1,Burgenland,18,35,25.7
4321,1622432,2021-06-07,26,3,222,50,2,Kärnten,29,53,5.7
4322,9505891,2021-06-07,41,31,299,116,3,Niederösterreich,72,147,21.1
4323,6779215,2021-06-07,29,17,221,58,4,Oberösterreich,46,75,22.7
4324,2548188,2021-06-07,11,4,112,48,5,Salzburg,15,52,7.7
4325,5743459,2021-06-07,24,8,472,91,6,Steiermark,32,99,8.1
4326,4453610,2021-06-07,21,16,174,32,7,Tirol,37,48,33.3
4327,2761583,2021-06-07,6,6,136,66,8,Vorarlberg,12,72,8.3
4328,10306257,2021-06-07,113,52,664,312,9,Wien,165,364,14.3
4329,45570994,2021-06-07,280,146,2397,799,10,Alle,426,945,15.4
4330,1865108,2021-06-08,8,8,99,27,1,Burgenland,16,35,22.9
4331,1622983,2021-06-08,28,3,223,50,2,Kärnten,31,53,5.7
4332,9554145,2021-06-08,42,30,298,98,3,Niederösterreich,72,128,23.4
4333,6851691,2021-06-08,25,14,225,61,4,Oberösterreich,39,75,18.7
4334,2592217,2021-06-08,11,4,112,48,5,Salzburg,15,52,7.7
4335,5814485,2021-06-08,30,6,464,94,6,Steiermark,36,100,6.0
4336,4464243,2021-06-08,16,14,172,34,7,Tirol,30,48,29.2
4337,2773203,2021-06-08,2,6,140,63,8,Vorarlberg,8,69,8.7
4338,10444930,2021-06-08,113,42,664,322,9,Wien,155,364,11.5
4339,45983005,2021-06-08,275,127,2397,797,10,Alle,402,924,13.7
4340,1874198,2021-06-09,6,8,98,27,1,Burgenland,14,35,22.9
4341,1623397,2021-06-09,20,3,223,50,2,Kärnten,23,53,5.7
4342,9585653,2021-06-09,37,29,97,90,3,Niederösterreich,66,119,24.4
4343,6916778,2021-06-09,19,15,231,61,4,Oberösterreich,34,76,19.7
4344,2617680,2021-06-09,12,3,111,49,5,Salzburg,15,52,5.8
4345,5888257,2021-06-09,30,5,464,93,6,Steiermark,35,98,5.1
4346,4582056,2021-06-09,13,13,174,35,7,Tirol,26,48,27.1
4347,2781377,2021-06-09,0,6,100,65,8,Vorarlberg,6,71,8.5
4348,10556770,2021-06-09,111,40,666,324,9,Wien,151,364,11.0
4349,46426166,2021-06-09,248,122,2164,794,10,Alle,370,916,13.3
4350,1893858,2021-06-10,8,4,96,31,1,Burgenland,12,35,11.4
4351,1804702,2021-06-10,25,3,223,50,2,Kärnten,28,53,5.7
4352,9623375,2021-06-10,42,25,92,89,3,Niederösterreich,67,114,21.9
4353,6985491,2021-06-10,17,14,233,61,4,Oberösterreich,31,75,18.7
4354,2645894,2021-06-10,10,3,113,49,5,Salzburg,13,52,5.8
4355,5946210,2021-06-10,28,5,466,90,6,Steiermark,33,95,5.3
4356,4590996,2021-06-10,15,12,172,34,7,Tirol,27,46,26.1
4357,2792740,2021-06-10,1,7,99,65,8,Vorarlberg,8,72,9.7
4358,10659403,2021-06-10,98,40,679,324,9,Wien,138,364,11.0
4359,46942669,2021-06-10,244,113,2173,793,10,Alle,357,906,12.5
4360,1905410,2021-06-11,6,4,104,31,1,Burgenland,10,35,11.4
4361,1804890,2021-06-11,25,3,224,50,2,Kärnten,28,53,5.7
4362,9665399,2021-06-11,41,24,93,98,3,Niederösterreich,65,122,19.7
4363,7048854,2021-06-11,17,13,233,62,4,Oberösterreich,30,75,17.3
4364,2672794,2021-06-11,9,3,114,49,5,Salzburg,12,52,5.8
4365,6000972,2021-06-11,18,3,471,93,6,Steiermark,21,96,3.1
4366,4599197,2021-06-11,13,12,176,26,7,Tirol,25,38,31.6
4367,2801409,2021-06-11,3,7,97,65,8,Vorarlberg,10,72,9.7
4368,10769255,2021-06-11,97,28,680,336,9,Wien,125,364,7.7
4369,47268180,2021-06-11,229,97,2192,810,10,Alle,326,907,10.7
4370,1930444,2021-06-12,5,4,103,31,1,Burgenland,9,35,11.4
4371,1805034,2021-06-12,27,3,223,51,2,Kärnten,30,54,5.6
4372,9715155,2021-06-12,38,25,96,115,3,Niederösterreich,63,140,17.9
4373,7145413,2021-06-12,14,11,236,64,4,Oberösterreich,25,75,14.7
4374,2712073,2021-06-12,10,2,113,50,5,Salzburg,12,52,3.8
4375,6091501,2021-06-12,9,3,481,94,6,Steiermark,12,97,3.1
4376,4611397,2021-06-12,13,11,168,26,7,Tirol,24,37,29.7
4377,2818988,2021-06-12,3,7,97,65,8,Vorarlberg,10,72,9.7
4378,10895429,2021-06-12,98,33,679,331,9,Wien,131,364,9.1
4379,47725434,2021-06-12,217,99,2196,827,10,Alle,316,926,10.7
4380,1944166,2021-06-13,6,4,104,31,1,Burgenland,10,35,11.4
4381,1805141,2021-06-13,28,3,222,51,2,Kärnten,31,54,5.6
4382,9797671,2021-06-13,38,25,96,115,3,Niederösterreich,63,140,17.9
4383,7240165,2021-06-13,15,11,235,64,4,Oberösterreich,26,75,14.7
4384,2751407,2021-06-13,10,2,113,50,5,Salzburg,12,52,3.8
4385,6171433,2021-06-13,9,3,481,94,6,Steiermark,12,97,3.1
4386,4620870,2021-06-13,12,11,168,26,7,Tirol,23,37,29.7
4387,2828315,2021-06-13,3,7,97,65,8,Vorarlberg,10,72,9.7
4388,10986811,2021-06-13,98,33,679,331,9,Wien,131,364,9.1
4389,48145979,2021-06-13,219,99,2195,827,10,Alle,318,926,10.7
4390,1959166,2021-06-14,6,3,104,32,1,Burgenland,9,35,8.6
4391,1805558,2021-06-14,26,3,223,51,2,Kärnten,29,54,5.6
4392,9832538,2021-06-14,28,26,106,111,3,Niederösterreich,54,137,19.0
4393,7331751,2021-06-14,16,11,234,64,4,Oberösterreich,27,75,14.7
4394,2782675,2021-06-14,8,1,115,51,5,Salzburg,9,52,1.9
4395,6235105,2021-06-14,10,3,481,96,6,Steiermark,13,99,3.0
4396,4631104,2021-06-14,12,11,170,27,7,Tirol,23,38,28.9
4397,2832446,2021-06-14,4,7,96,67,8,Vorarlberg,11,74,9.5
4398,11048387,2021-06-14,98,33,679,331,9,Wien,131,364,9.1
4399,48458730,2021-06-14,208,98,2208,830,10,Alle,306,928,10.6
4400,1972399,2021-06-15,4,3,105,32,1,Burgenland,7,35,8.6
4401,1805701,2021-06-15,26,3,224,51,2,Kärnten,29,54,5.6
4402,9872454,2021-06-15,30,25,104,96,3,Niederösterreich,55,121,20.7
4403,7391731,2021-06-15,16,12,234,63,4,Oberösterreich,28,75,16.0
4404,2829182,2021-06-15,8,1,115,51,5,Salzburg,9,52,1.9
4405,6302992,2021-06-15,9,2,482,97,6,Steiermark,11,99,2.0
4406,4639446,2021-06-15,12,9,150,29,7,Tirol,21,38,23.7
4407,2842061,2021-06-15,4,6,96,65,8,Vorarlberg,10,71,8.5
4408,11157197,2021-06-15,96,33,681,331,9,Wien,129,364,9.1
4409,48813163,2021-06-15,205,94,2191,815,10,Alle,299,909,10.3
4410,1983066,2021-06-16,3,3,107,32,1,Burgenland,6,35,8.6
4411,1806568,2021-06-16,25,3,224,50,2,Kärnten,28,53,5.7
4412,9956708,2021-06-16,28,22,106,90,3,Niederösterreich,50,112,19.6
4413,7457570,2021-06-16,11,12,239,63,4,Oberösterreich,23,75,16.0
4414,2855325,2021-06-16,8,1,110,51,5,Salzburg,9,52,1.9
4415,6356020,2021-06-16,10,2,485,100,6,Steiermark,12,102,2.0
4416,4645623,2021-06-16,12,9,146,29,7,Tirol,21,38,23.7
4417,2849408,2021-06-16,4,6,96,67,8,Vorarlberg,10,73,8.2
4418,11257571,2021-06-16,87,34,690,330,9,Wien,121,364,9.3
4419,49167859,2021-06-16,188,92,2203,812,10,Alle,280,904,10.2
4420,1995247,2021-06-17,4,3,108,32,1,Burgenland,7,35,8.6
4421,1975056,2021-06-17,25,3,223,50,2,Kärnten,28,53,5.7
4422,10028225,2021-06-17,27,21,107,92,3,Niederösterreich,48,113,18.6
4423,7528779,2021-06-17,11,11,242,64,4,Oberösterreich,22,75,14.7
4424,2884812,2021-06-17,7,1,111,51,5,Salzburg,8,52,1.9
4425,6407654,2021-06-17,10,1,186,54,6,Steiermark,11,55,1.8
4426,4653426,2021-06-17,13,8,147,29,7,Tirol,21,37,21.6
4427,2858657,2021-06-17,4,6,96,67,8,Vorarlberg,10,73,8.2
4428,11362050,2021-06-17,84,32,693,332,9,Wien,116,364,8.8
4429,49693906,2021-06-17,185,86,1913,771,10,Alle,271,857,10.0
4430,2006024,2021-06-18,5,3,106,32,1,Burgenland,8,35,8.6
4431,1977261,2021-06-18,22,3,227,51,2,Kärnten,25,54,5.6
4432,10116833,2021-06-18,26,20,108,77,3,Niederösterreich,46,97,20.6
4433,7595397,2021-06-18,7,11,243,64,4,Oberösterreich,18,75,14.7
4434,2913134,2021-06-18,10,1,108,48,5,Salzburg,11,49,2.0
4435,6469877,2021-06-18,7,0,189,51,6,Steiermark,7,51,0.0
4436,4772236,2021-06-18,11,7,158,31,7,Tirol,18,38,18.4
4437,2865649,2021-06-18,1,6,99,62,8,Vorarlberg,7,68,8.8
4438,11467186,2021-06-18,86,33,691,331,9,Wien,119,364,9.1
4439,50183597,2021-06-18,175,84,1929,747,10,Alle,259,831,10.1
4440,2026391,2021-06-19,5,3,108,32,1,Burgenland,8,35,8.6
4441,1977462,2021-06-19,21,3,227,51,2,Kärnten,24,54,5.6
4442,10222213,2021-06-19,24,21,110,96,3,Niederösterreich,45,117,17.9
4443,7687434,2021-06-19,7,11,243,64,4,Oberösterreich,18,75,14.7
4444,2950878,2021-06-19,9,1,109,51,5,Salzburg,10,52,1.9
4445,6555795,2021-06-19,6,0,190,51,6,Steiermark,6,51,0.0
4446,4783428,2021-06-19,9,7,162,30,7,Tirol,16,37,18.9
4447,2879780,2021-06-19,1,6,99,62,8,Vorarlberg,7,68,8.8
4448,11580548,2021-06-19,82,31,695,333,9,Wien,113,364,8.5
4449,50663929,2021-06-19,164,83,1943,770,10,Alle,247,853,9.7
4450,2039220,2021-06-20,4,3,108,32,1,Burgenland,7,35,8.6
4451,1977544,2021-06-20,21,3,227,51,2,Kärnten,24,54,5.6
4452,10320165,2021-06-20,24,21,110,114,3,Niederösterreich,45,135,15.6
4453,7776776,2021-06-20,6,11,244,64,4,Oberösterreich,17,75,14.7
4454,2988333,2021-06-20,8,1,110,51,5,Salzburg,9,52,1.9
4455,6634725,2021-06-20,6,0,190,52,6,Steiermark,6,52,0.0
4456,4792662,2021-06-20,8,7,160,31,7,Tirol,15,38,18.4
4457,2886022,2021-06-20,1,6,99,62,8,Vorarlberg,7,68,8.8
4458,11667419,2021-06-20,86,32,691,332,9,Wien,118,364,8.8
4459,51082866,2021-06-20,164,84,1939,789,10,Alle,248,873,9.6
4460,2052395,2021-06-21,3,3,109,32,1,Burgenland,6,35,8.6
4461,1977658,2021-06-21,19,2,227,51,2,Kärnten,21,53,3.8
4462,10414049,2021-06-21,23,19,111,116,3,Niederösterreich,42,135,14.1
4463,7863422,2021-06-21,11,11,245,64,4,Oberösterreich,22,75,14.7
4464,3019003,2021-06-21,8,1,110,51,5,Salzburg,9,52,1.9
4465,6702817,2021-06-21,6,0,190,52,6,Steiermark,6,52,0.0
4466,4801848,2021-06-21,10,7,153,29,7,Tirol,17,36,19.4
4467,2889717,2021-06-21,4,4,96,67,8,Vorarlberg,8,71,5.6
4468,11736974,2021-06-21,80,33,697,331,9,Wien,113,364,9.1
4469,51457883,2021-06-21,164,80,1938,793,10,Alle,244,873,9.2
4470,2063940,2021-06-22,5,2,107,33,1,Burgenland,7,35,5.7
4471,1978219,2021-06-22,19,2,225,51,2,Kärnten,21,53,3.8
4472,10484220,2021-06-22,27,18,107,103,3,Niederösterreich,45,121,14.9
4473,7920724,2021-06-22,12,12,238,63,4,Oberösterreich,24,75,16.0
4474,3052367,2021-06-22,8,0,110,52,5,Salzburg,8,52,0.0
4475,6766613,2021-06-22,6,0,190,52,6,Steiermark,6,52,0.0
4476,4809465,2021-06-22,9,6,148,30,7,Tirol,15,36,16.7
4477,3288639,2021-06-22,6,2,94,67,8,Vorarlberg,8,69,2.9
4478,11799322,2021-06-22,77,31,700,333,9,Wien,108,364,8.5
4479,52163509,2021-06-22,169,73,1919,784,10,Alle,242,857,8.5
4480,2073449,2021-06-23,5,2,98,33,1,Burgenland,7,35,5.7
4481,1981055,2021-06-23,20,2,224,51,2,Kärnten,22,53,3.8
4482,10553682,2021-06-23,23,17,111,107,3,Niederösterreich,40,124,13.7
4483,7973461,2021-06-23,8,12,242,63,4,Oberösterreich,20,75,16.0
4484,3074226,2021-06-23,3,0,105,51,5,Salzburg,3,51,0.0
4485,6853661,2021-06-23,4,0,192,52,6,Steiermark,4,52,0.0
4486,4815067,2021-06-23,6,7,150,31,7,Tirol,13,38,18.4
4487,3302104,2021-06-23,5,2,95,67,8,Vorarlberg,7,69,2.9
4488,11926667,2021-06-23,83,28,694,336,9,Wien,111,364,7.7
4489,52553372,2021-06-23,157,70,1911,791,10,Alle,227,861,8.1
4490,2083776,2021-06-24,5,2,107,33,1,Burgenland,7,35,5.7
4491,1981250,2021-06-24,21,2,224,51,2,Kärnten,23,53,3.8
4492,10621263,2021-06-24,19,15,115,100,3,Niederösterreich,34,115,13.0
4493,7994979,2021-06-24,8,11,242,64,4,Oberösterreich,19,75,14.7
4494,3097940,2021-06-24,3,0,105,50,5,Salzburg,3,50,0.0
4495,6909925,2021-06-24,3,1,193,50,6,Steiermark,4,51,2.0
4496,4821648,2021-06-24,7,6,146,30,7,Tirol,13,36,16.7
4497,3317855,2021-06-24,4,2,96,70,8,Vorarlberg,6,72,2.8
4498,12015642,2021-06-24,76,32,701,332,9,Wien,108,364,8.8
4499,52844278,2021-06-24,146,71,1929,780,10,Alle,217,851,8.3
4500,2093723,2021-06-25,5,2,104,33,1,Burgenland,7,35,5.7
4501,1981348,2021-06-25,18,2,226,51,2,Kärnten,20,53,3.8
4502,10690025,2021-06-25,13,14,121,112,3,Niederösterreich,27,126,11.1
4503,8082568,2021-06-25,8,11,242,64,4,Oberösterreich,19,75,14.7
4504,3120176,2021-06-25,3,0,105,52,5,Salzburg,3,52,0.0
4505,6962076,2021-06-25,3,1,193,50,6,Steiermark,4,51,2.0
4506,4928619,2021-06-25,6,5,148,27,7,Tirol,11,32,15.6
4507,3331638,2021-06-25,5,2,95,70,8,Vorarlberg,7,72,2.8
4508,12105765,2021-06-25,66,31,711,333,9,Wien,97,364,8.5
4509,53295938,2021-06-25,127,68,1945,792,10,Alle,195,860,7.9
4510,2103171,2021-06-26,5,2,104,33,1,Burgenland,7,35,5.7
4511,2004568,2021-06-26,15,3,227,50,2,Kärnten,18,53,5.7
4512,10774070,2021-06-26,13,14,121,115,3,Niederösterreich,27,129,10.9
4513,8155591,2021-06-26,9,11,241,64,4,Oberösterreich,20,75,14.7
4514,3150244,2021-06-26,3,0,105,52,5,Salzburg,3,52,0.0
4515,7035376,2021-06-26,2,1,194,52,6,Steiermark,3,53,1.9
4516,4937564,2021-06-26,5,6,152,25,7,Tirol,11,31,19.4
4517,3353242,2021-06-26,5,2,95,70,8,Vorarlberg,7,72,2.8
4518,12199720,2021-06-26,71,34,706,330,9,Wien,105,364,9.3
4519,53713546,2021-06-26,128,73,1945,791,10,Alle,201,864,8.4
4520,2122735,2021-06-27,5,2,104,33,1,Burgenland,7,35,5.7
4521,2004600,2021-06-27,15,3,227,50,2,Kärnten,18,53,5.7
4522,10860588,2021-06-27,12,12,122,122,3,Niederösterreich,24,134,9.0
4523,8230399,2021-06-27,9,11,241,64,4,Oberösterreich,20,75,14.7
4524,3182300,2021-06-27,2,0,106,52,5,Salzburg,2,52,0.0
4525,7108156,2021-06-27,2,1,194,52,6,Steiermark,3,53,1.9
4526,4945351,2021-06-27,5,6,151,25,7,Tirol,11,31,19.4
4527,3372599,2021-06-27,4,2,96,70,8,Vorarlberg,6,72,2.8
4528,12199720,2021-06-27,68,26,709,338,9,Wien,94,364,7.1
4529,54026448,2021-06-27,122,63,1950,806,10,Alle,185,869,7.2
4530,2133953,2021-06-28,5,2,105,33,1,Burgenland,7,35,5.7
4531,2004662,2021-06-28,16,3,226,51,2,Kärnten,19,54,5.6
4532,10946930,2021-06-28,13,12,121,113,3,Niederösterreich,25,125,9.6
4533,8309730,2021-06-28,7,11,243,64,4,Oberösterreich,18,75,14.7
4534,3210537,2021-06-28,2,0,106,52,5,Salzburg,2,52,0.0
4535,7168756,2021-06-28,3,1,188,56,6,Steiermark,4,57,1.8
4536,4953109,2021-06-28,5,6,149,25,7,Tirol,11,31,19.4
4537,3391186,2021-06-28,2,2,98,70,8,Vorarlberg,4,72,2.8
4538,12335199,2021-06-28,65,24,712,340,9,Wien,89,364,6.6
4539,54454062,2021-06-28,118,61,1948,804,10,Alle,179,865,7.1
4540,2146251,2021-06-29,4,2,108,33,1,Burgenland,6,35,5.7
4541,2004843,2021-06-29,18,2,225,50,2,Kärnten,20,52,3.8
4542,11017403,2021-06-29,15,12,119,96,3,Niederösterreich,27,108,11.1
4543,8364849,2021-06-29,11,9,239,66,4,Oberösterreich,20,75,12.0
4544,3243318,2021-06-29,4,0,100,52,5,Salzburg,4,52,0.0
4545,7229806,2021-06-29,3,1,185,55,6,Steiermark,4,56,1.8
4546,4959296,2021-06-29,5,5,149,26,7,Tirol,10,31,16.1
4547,3409273,2021-06-29,2,3,98,67,8,Vorarlberg,5,70,4.3
4548,12429991,2021-06-29,67,22,710,342,9,Wien,89,364,6.0
4549,54805030,2021-06-29,129,56,1933,787,10,Alle,185,843,6.6
4550,2155121,2021-06-30,4,2,105,33,1,Burgenland,6,35,5.7
4551,2005306,2021-06-30,18,2,226,51,2,Kärnten,20,53,3.8
4552,11067509,2021-06-30,18,12,116,91,3,Niederösterreich,30,103,11.7
4553,8409696,2021-06-30,4,6,246,69,4,Oberösterreich,10,75,8.0
4554,3262409,2021-06-30,4,0,96,51,5,Salzburg,4,51,0.0
4555,7293891,2021-06-30,3,1,187,53,6,Steiermark,4,54,1.9
4556,4964111,2021-06-30,4,5,150,22,7,Tirol,9,27,18.5
4557,3421341,2021-06-30,2,2,98,65,8,Vorarlberg,4,67,3.0
4558,12516893,2021-06-30,55,30,722,334,9,Wien,85,364,8.2
4559,55096277,2021-06-30,112,60,1946,769,10,Alle,172,829,7.2
4560,2160674,2021-07-01,4,3,105,32,1,Burgenland,7,35,8.6
4561,2005566,2021-07-01,15,2,228,51,2,Kärnten,17,53,3.8
4562,11138987,2021-07-01,17,13,117,85,3,Niederösterreich,30,98,13.3
4563,8464089,2021-07-01,6,6,244,69,4,Oberösterreich,12,75,8.0
4564,3283950,2021-07-01,4,0,100,52,5,Salzburg,4,52,0.0
4565,7293891,2021-07-01,2,2,280,50,6,Steiermark,4,52,3.8
4566,5066736,2021-07-01,5,4,151,26,7,Tirol,9,30,13.3
4567,3435819,2021-07-01,3,2,97,62,8,Vorarlberg,5,64,3.1
4568,12601512,2021-07-01,56,21,721,343,9,Wien,77,364,5.8
4569,55451224,2021-07-01,112,53,2043,770,10,Alle,165,823,6.4
4570,2166515,2021-07-02,4,2,105,33,1,Burgenland,6,35,5.7
4571,2005704,2021-07-02,14,2,229,51,2,Kärnten,16,53,3.8
4572,11200979,2021-07-02,14,12,120,94,3,Niederösterreich,26,106,11.3
4573,8515835,2021-07-02,4,6,246,69,4,Oberösterreich,10,75,8.0
4574,3306333,2021-07-02,3,0,75,51,5,Salzburg,3,51,0.0
4575,7293891,2021-07-02,2,1,184,51,6,Steiermark,3,52,1.9
4576,5073133,2021-07-02,5,4,153,26,7,Tirol,9,30,13.3
4577,3449291,2021-07-02,2,2,98,64,8,Vorarlberg,4,66,3.0
4578,12698933,2021-07-02,53,20,724,344,9,Wien,73,364,5.5
4579,55710614,2021-07-02,101,49,1934,783,10,Alle,150,832,5.9
4580,2192030,2021-07-03,4,2,104,33,1,Burgenland,6,35,5.7
4581,2005838,2021-07-03,14,2,229,51,2,Kärnten,16,53,3.8
4582,11272519,2021-07-03,11,9,123,84,3,Niederösterreich,20,93,9.7
4583,8592464,2021-07-03,4,6,246,69,4,Oberösterreich,10,75,8.0
4584,3335947,2021-07-03,3,0,75,51,5,Salzburg,3,51,0.0
4585,7293891,2021-07-03,2,2,180,47,6,Steiermark,4,49,4.1
4586,5083147,2021-07-03,7,3,156,26,7,Tirol,10,29,10.3
4587,3470674,2021-07-03,2,2,98,64,8,Vorarlberg,4,66,3.0
4588,12808039,2021-07-03,50,20,727,344,9,Wien,70,364,5.5
4589,56054549,2021-07-03,97,46,1938,769,10,Alle,143,815,5.6
4590,2203993,2021-07-04,4,2,106,33,1,Burgenland,6,35,5.7
4591,2005860,2021-07-04,14,2,228,51,2,Kärnten,16,53,3.8
4592,11351880,2021-07-04,8,9,126,100,3,Niederösterreich,17,109,8.3
4593,8677150,2021-07-04,4,6,246,69,4,Oberösterreich,10,75,8.0
4594,3369518,2021-07-04,3,0,75,51,5,Salzburg,3,51,0.0
4595,7538743,2021-07-04,2,3,180,45,6,Steiermark,5,48,6.2
4596,5091156,2021-07-04,6,3,156,26,7,Tirol,9,29,10.3
4597,3489689,2021-07-04,2,2,98,64,8,Vorarlberg,4,66,3.0
4598,12887825,2021-07-04,46,19,731,345,9,Wien,65,364,5.2
4599,56615814,2021-07-04,89,46,1946,784,10,Alle,135,830,5.5
4600,2216063,2021-07-05,4,2,106,33,1,Burgenland,6,35,5.7
4601,2005946,2021-07-05,14,2,227,51,2,Kärnten,16,53,3.8
4602,11425791,2021-07-05,7,9,127,113,3,Niederösterreich,16,122,7.4
4603,8748457,2021-07-05,3,6,247,69,4,Oberösterreich,9,75,8.0
4604,3393921,2021-07-05,3,0,75,52,5,Salzburg,3,52,0.0
4605,7588389,2021-07-05,3,2,179,47,6,Steiermark,5,49,4.1
4606,5098875,2021-07-05,6,3,151,26,7,Tirol,9,29,10.3
4607,3503656,2021-07-05,0,2,100,67,8,Vorarlberg,2,69,2.9
4608,12956818,2021-07-05,43,19,734,345,9,Wien,62,364,5.2
4609,56937916,2021-07-05,83,45,1946,803,10,Alle,128,848,5.3
4610,2227078,2021-07-06,5,1,106,34,1,Burgenland,6,35,2.9
4611,2026456,2021-07-06,14,2,227,51,2,Kärnten,16,53,3.8
4612,11497689,2021-07-06,7,9,127,102,3,Niederösterreich,16,111,8.1
4613,8804234,2021-07-06,7,6,243,69,4,Oberösterreich,13,75,8.0
4614,3423985,2021-07-06,3,0,75,52,5,Salzburg,3,52,0.0
4615,7642510,2021-07-06,1,2,178,49,6,Steiermark,3,51,3.9
4616,5105827,2021-07-06,4,3,152,26,7,Tirol,7,29,10.3
4617,3518471,2021-07-06,1,2,99,67,8,Vorarlberg,3,69,2.9
4618,13039047,2021-07-06,36,21,741,343,9,Wien,57,364,5.8
4619,57285297,2021-07-06,78,46,1948,793,10,Alle,124,839,5.5
4620,2239293,2021-07-07,5,1,105,34,1,Burgenland,6,35,2.9
4621,2027343,2021-07-07,15,2,228,50,2,Kärnten,17,52,3.8
4622,11568680,2021-07-07,5,9,129,91,3,Niederösterreich,14,100,9.0
4623,8864096,2021-07-07,4,5,246,70,4,Oberösterreich,9,75,6.7
4624,3448373,2021-07-07,4,0,74,52,5,Salzburg,4,52,0.0
4625,7707500,2021-07-07,0,1,179,48,6,Steiermark,1,49,2.0
4626,5111796,2021-07-07,3,3,151,26,7,Tirol,6,29,10.3
4627,3532307,2021-07-07,0,2,100,70,8,Vorarlberg,2,72,2.8
4628,13121897,2021-07-07,36,23,741,341,9,Wien,59,364,6.3
4629,57621285,2021-07-07,72,46,1953,782,10,Alle,118,828,5.6
4630,2249689,2021-07-08,4,1,104,34,1,Burgenland,5,35,2.9
4631,2027526,2021-07-08,13,2,228,50,2,Kärnten,15,52,3.8
4632,11635393,2021-07-08,7,8,127,97,3,Niederösterreich,15,105,7.6
4633,8920037,2021-07-08,3,5,247,70,4,Oberösterreich,8,75,6.7
4634,3472626,2021-07-08,4,0,74,52,5,Salzburg,4,52,0.0
4635,7760470,2021-07-08,0,1,179,47,6,Steiermark,1,48,2.1
4636,5184975,2021-07-08,3,3,152,26,7,Tirol,6,29,10.3
4637,3547051,2021-07-08,0,2,100,67,8,Vorarlberg,2,69,2.9
4638,13206040,2021-07-08,35,20,742,344,9,Wien,55,364,5.5
4639,58003807,2021-07-08,69,42,1953,787,10,Alle,111,829,5.1
4640,2261862,2021-07-09,3,1,108,34,1,Burgenland,4,35,2.9
4641,2027616,2021-07-09,12,2,229,50,2,Kärnten,14,52,3.8
4642,11699461,2021-07-09,7,9,127,107,3,Niederösterreich,16,116,7.8
4643,8972783,2021-07-09,3,4,247,71,4,Oberösterreich,7,75,5.3
4644,3496858,2021-07-09,3,0,75,52,5,Salzburg,3,52,0.0
4645,7819271,2021-07-09,1,1,189,48,6,Steiermark,2,49,2.0
4646,5192544,2021-07-09,3,2,152,27,7,Tirol,5,29,6.9
4647,3561206,2021-07-09,0,2,100,67,8,Vorarlberg,2,69,2.9
4648,13286436,2021-07-09,35,21,742,343,9,Wien,56,364,5.8
4649,58318037,2021-07-09,67,42,1969,799,10,Alle,109,841,5.0
4650,2280028,2021-07-10,1,1,110,34,1,Burgenland,2,35,2.9
4651,2027758,2021-07-10,10,2,228,51,2,Kärnten,12,53,3.8
4652,11774404,2021-07-10,6,9,128,93,3,Niederösterreich,15,102,8.8
4653,9053410,2021-07-10,3,3,247,72,4,Oberösterreich,6,75,4.0
4654,3530403,2021-07-10,3,0,71,52,5,Salzburg,3,52,0.0
4655,7898719,2021-07-10,1,1,181,51,6,Steiermark,2,52,1.9
4656,5203048,2021-07-10,4,2,154,25,7,Tirol,6,27,7.4
4657,3584352,2021-07-10,0,2,100,67,8,Vorarlberg,2,69,2.9
4658,13379811,2021-07-10,33,22,744,342,9,Wien,55,364,6.0
4659,58731933,2021-07-10,61,42,1963,787,10,Alle,103,829,5.1
4660,2294319,2021-07-11,1,1,108,34,1,Burgenland,2,35,2.9
4661,2027837,2021-07-11,10,2,228,51,2,Kärnten,12,53,3.8
4662,11859932,2021-07-11,6,9,128,112,3,Niederösterreich,15,121,7.4
4663,9139090,2021-07-11,3,3,247,72,4,Oberösterreich,6,75,4.0
4664,3565844,2021-07-11,3,0,71,52,5,Salzburg,3,52,0.0
4665,7976126,2021-07-11,1,1,181,51,6,Steiermark,2,52,1.9
4666,5213119,2021-07-11,4,2,151,27,7,Tirol,6,29,6.9
4667,3605956,2021-07-11,0,1,100,67,8,Vorarlberg,1,68,1.5
4668,13421638,2021-07-11,34,18,743,346,9,Wien,52,364,4.9
4669,59103861,2021-07-11,62,37,1957,812,10,Alle,99,849,4.4
4670,2303797,2021-07-12,1,1,111,34,1,Burgenland,2,35,2.9
4671,2027934,2021-07-12,10,2,228,51,2,Kärnten,12,53,3.8
4672,11921741,2021-07-12,9,9,125,113,3,Niederösterreich,18,122,7.4
4673,9207415,2021-07-12,3,3,247,72,4,Oberösterreich,6,75,4.0
4674,3589262,2021-07-12,3,0,71,52,5,Salzburg,3,52,0.0
4675,8025027,2021-07-12,1,1,180,50,6,Steiermark,2,51,2.0
4676,5221869,2021-07-12,4,2,149,27,7,Tirol,6,29,6.9
4677,3621793,2021-07-12,0,1,100,70,8,Vorarlberg,1,71,1.4
4678,13501183,2021-07-12,36,16,741,348,9,Wien,52,364,4.4
4679,59420021,2021-07-12,67,35,1952,817,10,Alle,102,852,4.1
4680,2315231,2021-07-13,2,0,110,35,1,Burgenland,2,35,0.0
4681,2028134,2021-07-13,10,2,229,51,2,Kärnten,12,53,3.8
4682,11983442,2021-07-13,11,9,123,110,3,Niederösterreich,20,119,7.6
4683,9268564,2021-07-13,9,2,241,73,4,Oberösterreich,11,75,2.7
4684,3631403,2021-07-13,4,0,70,49,5,Salzburg,4,49,0.0
4685,8091563,2021-07-13,2,1,178,50,6,Steiermark,3,51,2.0
4686,5230166,2021-07-13,4,1,149,26,7,Tirol,5,27,3.7
4687,3639021,2021-07-13,0,1,100,65,8,Vorarlberg,1,66,1.5
4688,13578972,2021-07-13,33,21,744,343,9,Wien,54,364,5.8
4689,59766496,2021-07-13,75,37,1944,802,10,Alle,112,839,4.4
4690,2325669,2021-07-14,1,0,109,35,1,Burgenland,1,35,0.0
4691,2028258,2021-07-14,14,2,227,51,2,Kärnten,16,53,3.8
4692,12038291,2021-07-14,15,9,119,100,3,Niederösterreich,24,109,8.3
4693,9285055,2021-07-14,6,2,244,73,4,Oberösterreich,8,75,2.7
4694,3654719,2021-07-14,2,0,72,49,5,Salzburg,2,49,0.0
4695,8160815,2021-07-14,3,1,177,47,6,Steiermark,4,48,2.1
4696,5237486,2021-07-14,3,0,151,27,7,Tirol,3,27,0.0
4697,3652329,2021-07-14,0,0,100,62,8,Vorarlberg,0,62,0.0
4698,13665654,2021-07-14,34,18,743,346,9,Wien,52,364,4.9
4699,60048276,2021-07-14,78,32,1942,790,10,Alle,110,822,3.9
4700,2335203,2021-07-15,1,0,110,35,1,Burgenland,1,35,0.0
4701,2412999,2021-07-15,14,2,227,54,2,Kärnten,16,56,3.6
4702,12099340,2021-07-15,12,9,122,94,3,Niederösterreich,21,103,8.7
4703,9386949,2021-07-15,6,2,244,73,4,Oberösterreich,8,75,2.7
4704,3681659,2021-07-15,2,0,72,49,5,Salzburg,2,49,0.0
4705,8216717,2021-07-15,4,2,180,46,6,Steiermark,6,48,4.2
4706,5277624,2021-07-15,3,1,150,27,7,Tirol,4,28,3.6
4707,3667742,2021-07-15,0,0,100,62,8,Vorarlberg,0,62,0.0
4708,13699486,2021-07-15,35,19,742,345,9,Wien,54,364,5.2
4709,60777719,2021-07-15,77,35,1947,785,10,Alle,112,820,4.3
4710,2345173,2021-07-16,2,0,110,35,1,Burgenland,2,35,0.0
4711,2413306,2021-07-16,12,2,228,55,2,Kärnten,14,57,3.5
4712,12154232,2021-07-16,10,9,124,93,3,Niederösterreich,19,102,8.8
4713,9448210,2021-07-16,5,2,245,73,4,Oberösterreich,7,75,2.7
4714,3708698,2021-07-16,3,0,71,51,5,Salzburg,3,51,0.0
4715,8272861,2021-07-16,5,2,178,49,6,Steiermark,7,51,3.9
4716,5285321,2021-07-16,3,1,151,26,7,Tirol,4,27,3.7
4717,3682921,2021-07-16,0,0,100,65,8,Vorarlberg,0,65,0.0
4718,13809541,2021-07-16,31,21,746,343,9,Wien,52,364,5.8
4719,61120263,2021-07-16,71,37,1953,790,10,Alle,108,827,4.5
4720,2362550,2021-07-17,2,0,107,35,1,Burgenland,2,35,0.0
4721,2413435,2021-07-17,12,2,228,55,2,Kärnten,14,57,3.5
4722,12231758,2021-07-17,12,7,122,113,3,Niederösterreich,19,120,5.8
4723,9535248,2021-07-17,5,2,245,73,4,Oberösterreich,7,75,2.7
4724,3742475,2021-07-17,3,0,71,51,5,Salzburg,3,51,0.0
4725,8349779,2021-07-17,6,2,178,51,6,Steiermark,8,53,3.8
4726,5296672,2021-07-17,4,0,156,28,7,Tirol,4,28,0.0
4727,3703578,2021-07-17,0,0,100,65,8,Vorarlberg,0,65,0.0
4728,13894039,2021-07-17,36,22,741,342,9,Wien,58,364,6.0
4729,61529534,2021-07-17,80,35,1948,813,10,Alle,115,848,4.1
4730,2374580,2021-07-18,2,0,109,35,1,Burgenland,2,35,0.0
4731,2413518,2021-07-18,12,2,228,55,2,Kärnten,14,57,3.5
4732,12306195,2021-07-18,10,6,124,113,3,Niederösterreich,16,119,5.0
4733,9622001,2021-07-18,5,2,245,73,4,Oberösterreich,7,75,2.7
4734,3775832,2021-07-18,3,0,71,51,5,Salzburg,3,51,0.0
4735,8422590,2021-07-18,4,2,180,51,6,Steiermark,6,53,3.8
4736,5306414,2021-07-18,6,0,153,26,7,Tirol,6,26,0.0
4737,3723417,2021-07-18,0,0,100,65,8,Vorarlberg,0,65,0.0
4738,13953387,2021-07-18,35,19,742,345,9,Wien,54,364,5.2
4739,61897934,2021-07-18,77,31,1952,814,10,Alle,108,845,3.7
4740,2386653,2021-07-19,3,0,105,35,1,Burgenland,3,35,0.0
4741,2413708,2021-07-19,12,2,227,56,2,Kärnten,14,58,3.4
4742,12358842,2021-07-19,9,6,125,126,3,Niederösterreich,15,132,4.5
4743,9685060,2021-07-19,4,2,246,73,4,Oberösterreich,6,75,2.7
4744,3796349,2021-07-19,2,0,68,50,5,Salzburg,2,50,0.0
4745,8464030,2021-07-19,4,2,180,50,6,Steiermark,6,52,3.8
4746,5314375,2021-07-19,6,0,149,26,7,Tirol,6,26,0.0
4747,3736595,2021-07-19,0,0,100,65,8,Vorarlberg,0,65,0.0
4748,14004832,2021-07-19,40,21,737,343,9,Wien,61,364,5.8
4749,62160444,2021-07-19,80,33,1937,824,10,Alle,113,857,3.9
4750,2396215,2021-07-20,2,0,107,35,1,Burgenland,2,35,0.0
4751,2543197,2021-07-20,8,1,229,57,2,Kärnten,9,58,1.7
4752,12412216,2021-07-20,10,5,124,105,3,Niederösterreich,15,110,4.5
4753,9741255,2021-07-20,5,2,245,73,4,Oberösterreich,7,75,2.7
4754,3835737,2021-07-20,2,0,68,50,5,Salzburg,2,50,0.0
4755,8520301,2021-07-20,4,3,180,46,6,Steiermark,7,49,6.1
4756,5322924,2021-07-20,4,0,149,28,7,Tirol,4,28,0.0
4757,3752942,2021-07-20,1,0,99,65,8,Vorarlberg,1,65,0.0
4758,14082118,2021-07-20,46,29,731,335,9,Wien,75,364,8.0
4759,62606905,2021-07-20,82,40,1932,794,10,Alle,122,834,4.8
4760,2405748,2021-07-21,2,0,108,35,1,Burgenland,2,35,0.0
4761,2546656,2021-07-21,12,1,229,55,2,Kärnten,13,56,1.8
4762,12461872,2021-07-21,13,4,121,103,3,Niederösterreich,17,107,3.7
4763,9796808,2021-07-21,2,2,248,73,4,Oberösterreich,4,75,2.7
4764,3861348,2021-07-21,3,0,67,52,5,Salzburg,3,52,0.0
4765,8591433,2021-07-21,4,2,180,48,6,Steiermark,6,50,4.0
4766,5330439,2021-07-21,3,0,151,27,7,Tirol,3,27,0.0
4767,3767898,2021-07-21,2,0,98,62,8,Vorarlberg,2,62,0.0
4768,14155926,2021-07-21,40,21,737,343,9,Wien,61,364,5.8
4769,62918128,2021-07-21,81,30,1939,798,10,Alle,111,828,3.6
4770,2414825,2021-07-22,2,0,108,35,1,Burgenland,2,35,0.0
4771,2547004,2021-07-22,8,0,229,52,2,Kärnten,8,52,0.0
4772,12521663,2021-07-22,12,4,122,106,3,Niederösterreich,16,110,3.6
4773,9862860,2021-07-22,2,2,248,73,4,Oberösterreich,4,75,2.7
4774,3892072,2021-07-22,4,0,66,51,5,Salzburg,4,51,0.0
4775,8648183,2021-07-22,5,2,176,47,6,Steiermark,7,49,4.1
4776,5358989,2021-07-22,3,0,150,26,7,Tirol,3,26,0.0
4777,3785106,2021-07-22,2,0,98,62,8,Vorarlberg,2,62,0.0
4778,14227187,2021-07-22,40,18,737,346,9,Wien,58,364,4.9
4779,63257889,2021-07-22,78,26,1934,798,10,Alle,104,824,3.2
4780,2424732,2021-07-23,0,1,111,34,1,Burgenland,1,35,2.9
4781,2547361,2021-07-23,7,0,229,51,2,Kärnten,7,51,0.0
4782,12572713,2021-07-23,11,4,123,104,3,Niederösterreich,15,108,3.7
4783,9926548,2021-07-23,2,2,248,73,4,Oberösterreich,4,75,2.7
4784,3920707,2021-07-23,4,0,68,50,5,Salzburg,4,50,0.0
4785,8704450,2021-07-23,4,2,177,47,6,Steiermark,6,49,4.1
4786,5367306,2021-07-23,4,0,150,26,7,Tirol,4,26,0.0
4787,3802538,2021-07-23,3,0,97,62,8,Vorarlberg,3,62,0.0
4788,14305095,2021-07-23,39,17,738,347,9,Wien,56,364,4.7
4789,63571450,2021-07-23,74,26,1941,794,10,Alle,100,820,3.2
4790,2438110,2021-07-24,0,1,111,34,1,Burgenland,1,35,2.9
4791,2547572,2021-07-24,7,0,229,56,2,Kärnten,7,56,0.0
4792,12647340,2021-07-24,11,5,123,105,3,Niederösterreich,16,110,4.5
4793,10010539,2021-07-24,5,1,245,74,4,Oberösterreich,6,75,1.3
4794,3956618,2021-07-24,4,0,68,50,5,Salzburg,4,50,0.0
4795,8776396,2021-07-24,5,2,176,47,6,Steiermark,7,49,4.1
4796,5378780,2021-07-24,4,1,156,26,7,Tirol,5,27,3.7
4797,3824126,2021-07-24,5,0,95,62,8,Vorarlberg,5,62,0.0
4798,14391665,2021-07-24,39,17,738,347,9,Wien,56,364,4.7
4799,63971146,2021-07-24,80,27,1941,801,10,Alle,107,828,3.3
4800,2448989,2021-07-25,0,1,85,34,1,Burgenland,1,35,2.9
4801,2547723,2021-07-25,8,0,228,55,2,Kärnten,8,55,0.0
4802,12720721,2021-07-25,8,5,126,111,3,Niederösterreich,13,116,4.3
4803,10094478,2021-07-25,5,1,245,74,4,Oberösterreich,6,75,1.3
4804,3993181,2021-07-25,4,0,68,50,5,Salzburg,4,50,0.0
4805,8848634,2021-07-25,5,1,176,48,6,Steiermark,6,49,2.0
4806,5389026,2021-07-25,4,1,155,22,7,Tirol,5,23,4.3
4807,3842369,2021-07-25,5,0,95,62,8,Vorarlberg,5,62,0.0
4808,14452112,2021-07-25,39,17,738,347,9,Wien,56,364,4.7
4809,64337233,2021-07-25,78,26,1916,803,10,Alle,104,829,3.1
4810,2457961,2021-07-26,0,1,108,34,1,Burgenland,1,35,2.9
4811,2547930,2021-07-26,8,0,228,57,2,Kärnten,8,57,0.0
4812,12771312,2021-07-26,8,5,126,111,3,Niederösterreich,13,116,4.3
4813,10159709,2021-07-26,9,1,241,74,4,Oberösterreich,10,75,1.3
4814,4018368,2021-07-26,2,0,70,52,5,Salzburg,2,52,0.0
4815,8894333,2021-07-26,5,2,176,48,6,Steiermark,7,50,4.0
4816,5396948,2021-07-26,4,1,151,24,7,Tirol,5,25,4.0
4817,3854991,2021-07-26,4,1,96,62,8,Vorarlberg,5,63,1.6
4818,14500388,2021-07-26,45,21,732,343,9,Wien,66,364,5.8
4819,64601940,2021-07-26,85,32,1928,805,10,Alle,117,837,3.8
4820,2467595,2021-07-27,0,1,108,34,1,Burgenland,1,35,2.9
4821,2597223,2021-07-27,8,0,227,53,2,Kärnten,8,53,0.0
4822,12815697,2021-07-27,11,6,123,106,3,Niederösterreich,17,112,5.4
4823,10218447,2021-07-27,9,1,241,74,4,Oberösterreich,10,75,1.3
4824,4056730,2021-07-27,2,0,66,52,5,Salzburg,2,52,0.0
4825,8955580,2021-07-27,6,2,172,50,6,Steiermark,8,52,3.8
4826,5405676,2021-07-27,3,2,144,23,7,Tirol,5,25,8.0
4827,3869090,2021-07-27,4,1,96,62,8,Vorarlberg,5,63,1.6
4828,14569778,2021-07-27,37,28,740,336,9,Wien,65,364,7.7
4829,64955816,2021-07-27,80,41,1917,790,10,Alle,121,831,4.9
4830,2480014,2021-07-28,0,1,107,34,1,Burgenland,1,35,2.9
4831,2737296,2021-07-28,9,0,227,51,2,Kärnten,9,51,0.0
4832,12863500,2021-07-28,7,6,127,103,3,Niederösterreich,13,109,5.5
4833,10274309,2021-07-28,8,2,242,73,4,Oberösterreich,10,75,2.7
4834,4083847,2021-07-28,2,0,66,52,5,Salzburg,2,52,0.0
4835,9016091,2021-07-28,5,2,173,50,6,Steiermark,7,52,3.8
4836,5412261,2021-07-28,3,2,142,25,7,Tirol,5,27,7.4
4837,3882551,2021-07-28,4,0,96,62,8,Vorarlberg,4,62,0.0
4838,14631891,2021-07-28,37,25,740,339,9,Wien,62,364,6.9
4839,65381760,2021-07-28,75,38,1920,789,10,Alle,113,827,4.6
4840,2489193,2021-07-29,1,1,110,34,1,Burgenland,2,35,2.9
4841,2739212,2021-07-29,8,1,228,50,2,Kärnten,9,51,2.0
4842,12918881,2021-07-29,8,6,126,102,3,Niederösterreich,14,108,5.6
4843,10335971,2021-07-29,10,2,240,73,4,Oberösterreich,12,75,2.7
4844,4116569,2021-07-29,2,0,66,52,5,Salzburg,2,52,0.0
4845,9066752,2021-07-29,4,2,174,50,6,Steiermark,6,52,3.8
4846,5464071,2021-07-29,5,2,142,25,7,Tirol,7,27,7.4
4847,3896921,2021-07-29,5,0,95,62,8,Vorarlberg,5,62,0.0
4848,14697491,2021-07-29,40,26,737,338,9,Wien,66,364,7.1
4849,65725061,2021-07-29,83,40,1918,786,10,Alle,123,826,4.8
4850,2498228,2021-07-30,0,1,108,34,1,Burgenland,1,35,2.9
4851,2882705,2021-07-30,9,1,227,51,2,Kärnten,10,52,1.9
4852,12975494,2021-07-30,6,6,128,80,3,Niederösterreich,12,86,7.0
4853,10398995,2021-07-30,12,2,238,73,4,Oberösterreich,14,75,2.7
4854,4149240,2021-07-30,2,0,66,52,5,Salzburg,2,52,0.0
4855,9117514,2021-07-30,5,1,173,50,6,Steiermark,6,51,2.0
4856,5487533,2021-07-30,6,2,141,24,7,Tirol,8,26,7.7
4857,3913604,2021-07-30,3,1,97,62,8,Vorarlberg,4,63,1.6
4858,14776429,2021-07-30,38,23,739,341,9,Wien,61,364,6.3
4859,66199742,2021-07-30,81,37,1917,767,10,Alle,118,804,4.6
4860,2514970,2021-07-31,1,1,111,34,1,Burgenland,2,35,2.9
4861,2895191,2021-07-31,9,1,227,51,2,Kärnten,10,52,1.9
4862,13033212,2021-07-31,6,6,128,79,3,Niederösterreich,12,85,7.1
4863,10478249,2021-07-31,13,2,237,73,4,Oberösterreich,15,75,2.7
4864,4185256,2021-07-31,3,0,65,52,5,Salzburg,3,52,0.0
4865,9183605,2021-07-31,6,0,172,52,6,Steiermark,6,52,0.0
4866,5498561,2021-07-31,4,3,135,24,7,Tirol,7,27,11.1
4867,3932134,2021-07-31,4,2,96,62,8,Vorarlberg,6,64,3.1
4868,14846127,2021-07-31,44,18,733,346,9,Wien,62,364,4.9
4869,66567305,2021-07-31,90,33,1904,773,10,Alle,123,806,4.1
4870,2525316,2021-08-01,1,1,108,34,1,Burgenland,2,35,2.9
4871,2902519,2021-08-01,8,1,227,51,2,Kärnten,9,52,1.9
4872,13095992,2021-08-01,5,5,129,112,3,Niederösterreich,10,117,4.3
4873,10554777,2021-08-01,14,2,236,73,4,Oberösterreich,16,75,2.7
4874,4225881,2021-08-01,3,0,65,52,5,Salzburg,3,52,0.0
4875,9248191,2021-08-01,7,0,171,52,6,Steiermark,7,52,0.0
4876,5508932,2021-08-01,3,3,135,24,7,Tirol,6,27,11.1
4877,3949440,2021-08-01,4,2,96,62,8,Vorarlberg,6,64,3.1
4878,14905695,2021-08-01,51,16,726,348,9,Wien,67,364,4.4
4879,66916743,2021-08-01,96,30,1893,808,10,Alle,126,838,3.6
4880,2532986,2021-08-02,1,1,108,34,1,Burgenland,2,35,2.9
4881,2902915,2021-08-02,8,1,227,51,2,Kärnten,9,52,1.9
4882,13179751,2021-08-02,8,6,126,122,3,Niederösterreich,14,128,4.7
4883,10619481,2021-08-02,14,3,236,72,4,Oberösterreich,17,75,4.0
4884,4250646,2021-08-02,2,0,65,52,5,Salzburg,2,52,0.0
4885,9284259,2021-08-02,7,0,171,52,6,Steiermark,7,52,0.0
4886,5518936,2021-08-02,9,3,128,23,7,Tirol,12,26,11.5
4887,3961420,2021-08-02,4,2,96,62,8,Vorarlberg,6,64,3.1
4888,14951518,2021-08-02,46,15,731,349,9,Wien,61,364,4.1
4889,67201912,2021-08-02,99,31,1888,817,10,Alle,130,848,3.7
4890,2543153,2021-08-03,0,1,109,34,1,Burgenland,1,35,2.9
4891,2907120,2021-08-03,8,1,227,51,2,Kärnten,9,52,1.9
4892,13235495,2021-08-03,10,6,124,97,3,Niederösterreich,16,103,5.8
4893,10685155,2021-08-03,15,3,235,72,4,Oberösterreich,18,75,4.0
4894,4288787,2021-08-03,3,1,65,51,5,Salzburg,4,52,1.9
4895,9338471,2021-08-03,7,1,171,51,6,Steiermark,8,52,1.9
4896,5528382,2021-08-03,15,3,125,23,7,Tirol,18,26,11.5
4897,3976846,2021-08-03,4,2,96,62,8,Vorarlberg,6,64,3.1
4898,14985021,2021-08-03,40,17,737,347,9,Wien,57,364,4.7
4899,67488430,2021-08-03,102,35,1889,788,10,Alle,137,823,4.3
4900,2550682,2021-08-04,0,1,111,34,1,Burgenland,1,35,2.9
4901,2908932,2021-08-04,9,1,227,51,2,Kärnten,10,52,1.9
4902,13284346,2021-08-04,11,5,123,97,3,Niederösterreich,16,102,4.9
4903,10740863,2021-08-04,14,3,236,72,4,Oberösterreich,17,75,4.0
4904,4317832,2021-08-04,3,1,75,51,5,Salzburg,4,52,1.9
4905,9395109,2021-08-04,11,2,167,48,6,Steiermark,13,50,4.0
4906,5537315,2021-08-04,11,4,131,24,7,Tirol,15,28,14.3
4907,3990600,2021-08-04,3,1,97,62,8,Vorarlberg,4,63,1.6
4908,15045879,2021-08-04,34,13,743,351,9,Wien,47,364,3.6
4909,67771558,2021-08-04,96,31,1910,790,10,Alle,127,821,3.8
4910,2558386,2021-08-05,0,1,111,34,1,Burgenland,1,35,2.9
4911,3046545,2021-08-05,9,1,226,51,2,Kärnten,10,52,1.9
4912,13346139,2021-08-05,11,5,123,98,3,Niederösterreich,16,103,4.9
4913,10803193,2021-08-05,11,3,239,72,4,Oberösterreich,14,75,4.0
4914,4351539,2021-08-05,2,1,66,51,5,Salzburg,3,52,1.9
4915,9453147,2021-08-05,14,4,164,46,6,Steiermark,18,50,8.0
4916,5559791,2021-08-05,8,4,129,23,7,Tirol,12,27,14.8
4917,4005664,2021-08-05,2,1,98,62,8,Vorarlberg,3,63,1.6
4918,15112334,2021-08-05,38,18,739,346,9,Wien,56,364,4.9
4919,68236738,2021-08-05,95,38,1895,783,10,Alle,133,821,4.6
4920,2566695,2021-08-06,1,1,109,34,1,Burgenland,2,35,2.9
4921,3046935,2021-08-06,12,1,224,52,2,Kärnten,13,53,1.9
4922,13393116,2021-08-06,15,4,119,106,3,Niederösterreich,19,110,3.6
4923,10860034,2021-08-06,14,2,236,73,4,Oberösterreich,16,75,2.7
4924,4383628,2021-08-06,4,1,74,53,5,Salzburg,5,54,1.9
4925,9501102,2021-08-06,11,5,167,46,6,Steiermark,16,51,9.8
4926,5569850,2021-08-06,10,4,127,20,7,Tirol,14,24,16.7
4927,4020521,2021-08-06,3,1,97,62,8,Vorarlberg,4,63,1.6
4928,15183652,2021-08-06,42,15,735,349,9,Wien,57,364,4.1
4929,68525533,2021-08-06,112,34,1888,795,10,Alle,146,829,4.1
4930,2577995,2021-08-07,2,1,108,34,1,Burgenland,3,35,2.9
4931,3059190,2021-08-07,12,2,224,51,2,Kärnten,14,53,3.8
4932,13461545,2021-08-07,15,5,119,109,3,Niederösterreich,20,114,4.4
4933,10932246,2021-08-07,13,2,237,73,4,Oberösterreich,15,75,2.7
4934,4425367,2021-08-07,4,1,74,53,5,Salzburg,5,54,1.9
4935,9568400,2021-08-07,10,6,170,46,6,Steiermark,16,52,11.5
4936,5592467,2021-08-07,14,4,130,16,7,Tirol,18,20,20.0
4937,4039944,2021-08-07,3,1,97,62,8,Vorarlberg,4,63,1.6
4938,15279536,2021-08-07,37,19,740,345,9,Wien,56,364,5.2
4939,68936690,2021-08-07,110,41,1899,789,10,Alle,151,830,4.9
4940,2588272,2021-08-08,2,1,109,34,1,Burgenland,3,35,2.9
4941,3059329,2021-08-08,11,2,225,52,2,Kärnten,13,54,3.7
4942,13532624,2021-08-08,17,5,117,109,3,Niederösterreich,22,114,4.4
4943,11009949,2021-08-08,17,4,233,71,4,Oberösterreich,21,75,5.3
4944,4466674,2021-08-08,5,1,74,53,5,Salzburg,6,54,1.9
4945,9638965,2021-08-08,10,8,168,44,6,Steiermark,18,52,15.4
4946,5604332,2021-08-08,16,3,128,16,7,Tirol,19,19,15.8
4947,4057687,2021-08-08,5,1,95,62,8,Vorarlberg,6,63,1.6
4948,15325371,2021-08-08,36,19,741,345,9,Wien,55,364,5.2
4949,69283203,2021-08-08,119,44,1890,786,10,Alle,163,830,5.3
4950,2596181,2021-08-09,1,1,110,34,1,Burgenland,2,35,2.9
4951,3059995,2021-08-09,16,2,220,51,2,Kärnten,18,53,3.8
4952,13586145,2021-08-09,18,4,116,111,3,Niederösterreich,22,115,3.5
4953,11071913,2021-08-09,20,4,230,71,4,Oberösterreich,24,75,5.3
4954,4492570,2021-08-09,6,1,66,51,5,Salzburg,7,52,1.9
4955,9678241,2021-08-09,10,8,170,44,6,Steiermark,18,52,15.4
4956,5614835,2021-08-09,18,3,123,21,7,Tirol,21,24,12.5
4957,4070505,2021-08-09,6,1,94,67,8,Vorarlberg,7,68,1.5
4958,15367560,2021-08-09,39,16,738,348,9,Wien,55,364,4.4
4959,69537945,2021-08-09,134,40,1867,798,10,Alle,174,838,4.8
4960,2614580,2021-08-10,2,1,110,34,1,Burgenland,3,35,2.9
4961,3061590,2021-08-10,17,2,218,50,2,Kärnten,19,52,3.8
4962,13638914,2021-08-10,22,4,112,107,3,Niederösterreich,26,111,3.6
4963,11127656,2021-08-10,23,4,227,71,4,Oberösterreich,27,75,5.3
4964,4529397,2021-08-10,8,3,64,49,5,Salzburg,11,52,5.8
4965,9731220,2021-08-10,15,9,165,44,6,Steiermark,24,53,17.0
4966,5624683,2021-08-10,20,6,122,18,7,Tirol,26,24,25.0
4967,4086025,2021-08-10,4,1,96,65,8,Vorarlberg,5,66,1.5
4968,15430120,2021-08-10,35,16,742,348,9,Wien,51,364,4.4
4969,69844185,2021-08-10,146,46,1856,786,10,Alle,192,832,5.5
4970,2622128,2021-08-11,2,1,108,34,1,Burgenland,3,35,2.9
4971,3063941,2021-08-11,18,2,218,51,2,Kärnten,20,53,3.8
4972,13651107,2021-08-11,24,4,110,108,3,Niederösterreich,28,112,3.6
4973,11188620,2021-08-11,20,5,230,70,4,Oberösterreich,25,75,6.7
4974,4560633,2021-08-11,8,3,74,49,5,Salzburg,11,52,5.8
4975,9789618,2021-08-11,14,7,166,44,6,Steiermark,21,51,13.7
4976,5633620,2021-08-11,17,7,123,21,7,Tirol,24,28,25.0
4977,4101094,2021-08-11,5,2,95,63,8,Vorarlberg,7,65,3.1
4978,15497838,2021-08-11,38,17,739,347,9,Wien,55,364,4.7
4979,70108599,2021-08-11,146,48,1863,787,10,Alle,194,835,5.7
4980,2630247,2021-08-12,2,1,108,34,1,Burgenland,3,35,2.9
4981,3207020,2021-08-12,15,2,218,51,2,Kärnten,17,53,3.8
4982,13714222,2021-08-12,26,4,108,99,3,Niederösterreich,30,103,3.9
4983,11253459,2021-08-12,15,5,235,70,4,Oberösterreich,20,75,6.7
4984,4593615,2021-08-12,10,3,61,46,5,Salzburg,13,49,6.1
4985,9840551,2021-08-12,16,7,164,42,6,Steiermark,23,49,14.3
4986,5643314,2021-08-12,18,5,123,23,7,Tirol,23,28,17.9
4987,4118207,2021-08-12,6,2,94,62,8,Vorarlberg,8,64,3.1
4988,15555771,2021-08-12,42,20,735,344,9,Wien,62,364,5.5
4989,70556406,2021-08-12,150,49,1846,771,10,Alle,199,820,6.0
4990,2638633,2021-08-13,3,1,109,34,1,Burgenland,4,35,2.9
4991,3207297,2021-08-13,16,2,235,51,2,Kärnten,18,53,3.8
4992,13751787,2021-08-13,29,3,105,91,3,Niederösterreich,32,94,3.2
4993,11314138,2021-08-13,14,6,236,69,4,Oberösterreich,20,75,8.0
4994,4627285,2021-08-13,10,3,71,46,5,Salzburg,13,49,6.1
4995,9892971,2021-08-13,17,7,163,42,6,Steiermark,24,49,14.3
4996,5653660,2021-08-13,16,5,124,23,7,Tirol,21,28,17.9
4997,4135620,2021-08-13,7,3,93,62,8,Vorarlberg,10,65,4.6
4998,15615562,2021-08-13,46,19,731,345,9,Wien,65,364,5.2
4999,70836953,2021-08-13,158,49,1867,763,10,Alle,207,812,6.0
5000,2651738,2021-08-14,2,1,110,34,1,Burgenland,3,35,2.9
5001,3217965,2021-08-14,15,2,218,51,2,Kärnten,17,53,3.8
5002,13834722,2021-08-14,33,5,101,109,3,Niederösterreich,38,114,4.4
5003,11390158,2021-08-14,24,5,226,70,4,Oberösterreich,29,75,6.7
5004,4668324,2021-08-14,9,3,71,46,5,Salzburg,12,49,6.1
5005,9919930,2021-08-14,19,8,161,43,6,Steiermark,27,51,15.7
5006,5668155,2021-08-14,11,7,128,21,7,Tirol,18,28,25.0
5007,4155974,2021-08-14,8,3,92,62,8,Vorarlberg,11,65,4.6
5008,15674778,2021-08-14,46,19,731,345,9,Wien,65,364,5.2
5009,71181744,2021-08-14,167,53,1838,781,10,Alle,220,834,6.4
5010,2660989,2021-08-15,2,1,107,34,1,Burgenland,3,35,2.9
5011,3218159,2021-08-15,17,2,216,51,2,Kärnten,19,53,3.8
5012,13904982,2021-08-15,35,5,99,112,3,Niederösterreich,40,117,4.3
5013,11472878,2021-08-15,26,5,224,70,4,Oberösterreich,31,75,6.7
5014,4709322,2021-08-15,8,3,71,46,5,Salzburg,11,49,6.1
5015,10022024,2021-08-15,22,9,158,42,6,Steiermark,31,51,17.6
5016,5679969,2021-08-15,11,7,115,21,7,Tirol,18,28,25.0
5017,4176627,2021-08-15,10,3,90,62,8,Vorarlberg,13,65,4.6
5018,15732499,2021-08-15,51,23,726,341,9,Wien,74,364,6.3
5019,71577449,2021-08-15,182,58,1806,779,10,Alle,240,837,6.9
5020,2667981,2021-08-16,3,1,107,34,1,Burgenland,4,35,2.9
5021,3219312,2021-08-16,11,5,223,48,2,Kärnten,16,53,9.4
5022,13967558,2021-08-16,36,5,98,130,3,Niederösterreich,41,135,3.7
5023,11546843,2021-08-16,32,6,218,69,4,Oberösterreich,38,75,8.0
5024,4738848,2021-08-16,7,4,65,44,5,Salzburg,11,48,8.3
5025,10065896,2021-08-16,24,9,156,42,6,Steiermark,33,51,17.6
5026,5689506,2021-08-16,14,7,126,21,7,Tirol,21,28,25.0
5027,4193271,2021-08-16,12,2,88,62,8,Vorarlberg,14,64,3.1
5028,15778635,2021-08-16,54,25,723,339,9,Wien,79,364,6.9
5029,71867850,2021-08-16,193,64,1804,789,10,Alle,257,853,7.5
5030,2676535,2021-08-17,3,1,107,34,1,Burgenland,4,35,2.9
5031,3223416,2021-08-17,13,5,222,48,2,Kärnten,18,53,9.4
5032,14017921,2021-08-17,38,6,96,118,3,Niederösterreich,44,124,4.8
5033,11595901,2021-08-17,32,7,218,68,4,Oberösterreich,39,75,9.3
5034,4775135,2021-08-17,10,4,62,44,5,Salzburg,14,48,8.3
5035,10120285,2021-08-17,24,9,156,42,6,Steiermark,33,51,17.6
5036,5699270,2021-08-17,16,6,123,22,7,Tirol,22,28,21.4
5037,4206607,2021-08-17,11,2,89,62,8,Vorarlberg,13,64,3.1
5038,15840185,2021-08-17,67,20,710,344,9,Wien,87,364,5.5
5039,72155255,2021-08-17,214,60,1783,782,10,Alle,274,842,7.1
5040,2682806,2021-08-18,3,1,109,34,1,Burgenland,4,35,2.9
5041,3225966,2021-08-18,15,4,221,49,2,Kärnten,19,53,7.5
5042,14065720,2021-08-18,45,6,89,108,3,Niederösterreich,51,114,5.3
5043,11651463,2021-08-18,32,7,218,68,4,Oberösterreich,39,75,9.3
5044,4805291,2021-08-18,9,4,63,44,5,Salzburg,13,48,8.3
5045,10150988,2021-08-18,25,10,155,39,6,Steiermark,35,49,20.4
5046,5719893,2021-08-18,16,7,125,21,7,Tirol,23,28,25.0
5047,4219886,2021-08-18,13,2,87,62,8,Vorarlberg,15,64,3.1
5048,15902874,2021-08-18,68,21,709,343,9,Wien,89,364,5.8
5049,72424887,2021-08-18,226,62,1776,768,10,Alle,288,830,7.5
5050,2691302,2021-08-19,5,1,107,34,1,Burgenland,6,35,2.9
5051,3378769,2021-08-19,13,5,221,47,2,Kärnten,18,52,9.6
5052,14113145,2021-08-19,40,9,94,108,3,Niederösterreich,49,117,7.7
5053,11703674,2021-08-19,42,6,208,69,4,Oberösterreich,48,75,8.0
5054,4835629,2021-08-19,9,4,62,45,5,Salzburg,13,49,8.2
5055,10218867,2021-08-19,25,11,155,38,6,Steiermark,36,49,22.4
5056,5729581,2021-08-19,15,9,128,20,7,Tirol,24,29,31.0
5057,4234426,2021-08-19,10,2,90,62,8,Vorarlberg,12,64,3.1
5058,15962352,2021-08-19,60,21,717,343,9,Wien,81,364,5.8
5059,72867745,2021-08-19,219,68,1782,766,10,Alle,287,834,8.2
5060,2698360,2021-08-20,7,0,104,35,1,Burgenland,7,35,0.0
5061,3379163,2021-08-20,13,5,221,47,2,Kärnten,18,52,9.6
5062,14165204,2021-08-20,41,10,93,107,3,Niederösterreich,51,117,8.5
5063,11763943,2021-08-20,42,8,208,67,4,Oberösterreich,50,75,10.7
5064,4865916,2021-08-20,11,4,60,45,5,Salzburg,15,49,8.2
5065,10266082,2021-08-20,33,11,146,38,6,Steiermark,44,49,22.4
5066,5739151,2021-08-20,20,7,126,22,7,Tirol,27,29,24.1
5067,4249482,2021-08-20,12,2,88,62,8,Vorarlberg,14,64,3.1
5068,16009055,2021-08-20,67,22,710,342,9,Wien,89,364,6.0
5069,73136356,2021-08-20,246,69,1756,765,10,Alle,315,834,8.3
5070,2708133,2021-08-21,7,0,104,35,1,Burgenland,7,35,0.0
5071,3389743,2021-08-21,13,5,221,48,2,Kärnten,18,53,9.4
5072,14229083,2021-08-21,42,11,92,95,3,Niederösterreich,53,106,10.4
5073,11836158,2021-08-21,48,10,202,65,4,Oberösterreich,58,75,13.3
5074,4905441,2021-08-21,15,4,60,45,5,Salzburg,19,49,8.2
5075,10322177,2021-08-21,27,11,151,37,6,Steiermark,38,48,22.9
5076,5751320,2021-08-21,22,6,120,23,7,Tirol,28,29,20.7
5077,4267729,2021-08-21,10,2,90,62,8,Vorarlberg,12,64,3.1
5078,16092764,2021-08-21,76,22,701,342,9,Wien,98,364,6.0
5079,73502548,2021-08-21,260,71,1741,752,10,Alle,331,823,8.6
5080,2717628,2021-08-22,8,0,103,35,1,Burgenland,8,35,0.0
5081,3389994,2021-08-22,13,4,221,48,2,Kärnten,17,52,7.7
5082,14300736,2021-08-22,44,14,90,101,3,Niederösterreich,58,115,12.2
5083,11915126,2021-08-22,52,14,198,61,4,Oberösterreich,66,75,18.7
5084,4943735,2021-08-22,17,4,60,45,5,Salzburg,21,49,8.2
5085,10392712,2021-08-22,25,11,153,38,6,Steiermark,36,49,22.4
5086,5762047,2021-08-22,25,6,121,23,7,Tirol,31,29,20.7
5087,4286911,2021-08-22,11,2,89,62,8,Vorarlberg,13,64,3.1
5088,16123745,2021-08-22,83,18,694,346,9,Wien,101,364,4.9
5089,73832634,2021-08-22,278,73,1729,759,10,Alle,351,832,8.8
5090,2725221,2021-08-23,7,0,104,35,1,Burgenland,7,35,0.0
5091,3390884,2021-08-23,16,4,219,47,2,Kärnten,20,51,7.8
5092,14356398,2021-08-23,45,14,89,110,3,Niederösterreich,59,124,11.3
5093,11977725,2021-08-23,61,13,189,62,4,Oberösterreich,74,75,17.3
5094,4967645,2021-08-23,22,4,57,45,5,Salzburg,26,49,8.2
5095,10435287,2021-08-23,27,10,151,39,6,Steiermark,37,49,20.4
5096,5770965,2021-08-23,25,6,122,22,7,Tirol,31,28,21.4
5097,4297871,2021-08-23,12,3,88,62,8,Vorarlberg,15,65,4.6
5098,16194692,2021-08-23,91,20,686,344,9,Wien,111,364,5.5
5099,74116688,2021-08-23,306,74,1705,766,10,Alle,380,840,8.8
5100,2732941,2021-08-24,7,2,103,33,1,Burgenland,9,35,5.7
5101,3396393,2021-08-24,17,4,219,48,2,Kärnten,21,52,7.7
5102,14404229,2021-08-24,55,15,79,91,3,Niederösterreich,70,106,14.2
5103,12026117,2021-08-24,58,15,192,60,4,Oberösterreich,73,75,20.0
5104,5007198,2021-08-24,20,3,69,46,5,Salzburg,23,49,6.1
5105,10485451,2021-08-24,32,11,146,39,6,Steiermark,43,50,22.0
5106,5779559,2021-08-24,26,6,122,21,7,Tirol,32,27,22.2
5107,4311342,2021-08-24,12,4,88,62,8,Vorarlberg,16,66,6.1
5108,16251445,2021-08-24,90,26,687,338,9,Wien,116,364,7.1
5109,74394675,2021-08-24,317,86,1705,738,10,Alle,403,824,10.4
5110,2739606,2021-08-25,10,2,101,33,1,Burgenland,12,35,5.7
5111,3397100,2021-08-25,15,4,220,48,2,Kärnten,19,52,7.7
5112,14445035,2021-08-25,54,14,80,96,3,Niederösterreich,68,110,12.7
5113,12079011,2021-08-25,64,17,186,58,4,Oberösterreich,81,75,22.7
5114,5033576,2021-08-25,22,2,68,47,5,Salzburg,24,49,4.1
5115,10538602,2021-08-25,35,13,143,37,6,Steiermark,48,50,26.0
5116,5799365,2021-08-25,23,6,125,18,7,Tirol,29,24,25.0
5117,4324131,2021-08-25,8,5,92,62,8,Vorarlberg,13,67,7.5
5118,16319694,2021-08-25,101,25,676,339,9,Wien,126,364,6.9
5119,74676120,2021-08-25,332,88,1691,738,10,Alle,420,826,10.7
5120,2747484,2021-08-26,9,1,103,34,1,Burgenland,10,35,2.9
5121,3540847,2021-08-26,16,4,220,47,2,Kärnten,20,51,7.8
5122,14499652,2021-08-26,50,15,84,102,3,Niederösterreich,65,117,12.8
5123,12138214,2021-08-26,65,16,185,59,4,Oberösterreich,81,75,21.3
5124,5063528,2021-08-26,22,2,63,47,5,Salzburg,24,49,4.1
5125,10579866,2021-08-26,35,14,143,36,6,Steiermark,49,50,28.0
5126,5807109,2021-08-26,19,5,128,21,7,Tirol,24,26,19.2
5127,4338518,2021-08-26,10,6,90,62,8,Vorarlberg,16,68,8.8
5128,16383636,2021-08-26,89,31,688,333,9,Wien,120,364,8.5
5129,75098854,2021-08-26,315,94,1704,741,10,Alle,409,835,11.3
5130,2753733,2021-08-27,9,1,100,34,1,Burgenland,10,35,2.9
5131,3541283,2021-08-27,16,4,221,48,2,Kärnten,20,52,7.7
5132,14548224,2021-08-27,50,18,84,120,3,Niederösterreich,68,138,13.0
5133,12188246,2021-08-27,65,21,185,54,4,Oberösterreich,86,75,28.0
5134,5091560,2021-08-27,18,3,67,46,5,Salzburg,21,49,6.1
5135,10621052,2021-08-27,38,14,139,37,6,Steiermark,52,51,27.5
5136,5815012,2021-08-27,20,5,128,23,7,Tirol,25,28,17.9
5137,4351614,2021-08-27,11,6,89,62,8,Vorarlberg,17,68,8.8
5138,16443577,2021-08-27,89,33,688,331,9,Wien,122,364,9.1
5139,75354301,2021-08-27,316,105,1701,755,10,Alle,421,860,12.2
5140,2767135,2021-08-28,10,2,102,33,1,Burgenland,12,35,5.7
5141,3550900,2021-08-28,18,4,219,48,2,Kärnten,22,52,7.7
5142,14590193,2021-08-28,54,21,80,126,3,Niederösterreich,75,147,14.3
5143,12256025,2021-08-28,57,23,193,52,4,Oberösterreich,80,75,30.7
5144,5127916,2021-08-28,21,3,52,45,5,Salzburg,24,48,6.2
5145,10680986,2021-08-28,38,13,141,38,6,Steiermark,51,51,25.5
5146,5826704,2021-08-28,20,4,124,23,7,Tirol,24,27,14.8
5147,4368825,2021-08-28,10,6,90,65,8,Vorarlberg,16,71,8.5
5148,16512041,2021-08-28,87,34,690,330,9,Wien,121,364,9.3
5149,75680725,2021-08-28,315,110,1691,760,10,Alle,425,870,12.6
5150,2776125,2021-08-29,9,2,101,33,1,Burgenland,11,35,5.7
5151,3551153,2021-08-29,19,6,217,47,2,Kärnten,25,53,11.3
5152,14676731,2021-08-29,57,23,77,121,3,Niederösterreich,80,144,16.0
5153,12329559,2021-08-29,60,23,190,52,4,Oberösterreich,83,75,30.7
5154,5161226,2021-08-29,29,4,52,45,5,Salzburg,33,49,8.2
5155,10736277,2021-08-29,42,13,137,38,6,Steiermark,55,51,25.5
5156,5836199,2021-08-29,25,4,119,23,7,Tirol,29,27,14.8
5157,4384792,2021-08-29,13,5,87,65,8,Vorarlberg,18,70,7.1
5158,16560946,2021-08-29,89,33,688,331,9,Wien,122,364,9.1
5159,76013008,2021-08-29,343,113,1668,755,10,Alle,456,868,13.0
5160,2782931,2021-08-30,10,1,102,34,1,Burgenland,11,35,2.9
5161,3551767,2021-08-30,19,5,217,47,2,Kärnten,24,52,9.6
5162,14729499,2021-08-30,59,24,75,121,3,Niederösterreich,83,145,16.6
5163,12388346,2021-08-30,63,26,187,49,4,Oberösterreich,89,75,34.7
5164,5182671,2021-08-30,29,4,52,45,5,Salzburg,33,49,8.2
5165,10771540,2021-08-30,49,16,130,35,6,Steiermark,65,51,31.4
5166,5843541,2021-08-30,24,4,125,23,7,Tirol,28,27,14.8
5167,4395094,2021-08-30,16,3,84,70,8,Vorarlberg,19,73,4.1
5168,16598253,2021-08-30,86,41,691,323,9,Wien,127,364,11.3
5169,76243642,2021-08-30,355,124,1663,747,10,Alle,479,871,14.2
5170,2791257,2021-08-31,10,1,100,34,1,Burgenland,11,35,2.9
5171,3555562,2021-08-31,20,7,216,47,2,Kärnten,27,54,13.0
5172,14777235,2021-08-31,68,24,66,102,3,Niederösterreich,92,126,19.0
5173,12437817,2021-08-31,63,26,187,49,4,Oberösterreich,89,75,34.7
5174,5219203,2021-08-31,31,5,49,44,5,Salzburg,36,49,10.2
5175,10816555,2021-08-31,52,17,127,33,6,Steiermark,69,50,34.0
5176,5850693,2021-08-31,27,5,125,22,7,Tirol,32,27,18.5
5177,4407614,2021-08-31,16,4,84,67,8,Vorarlberg,20,71,5.6
5178,16662168,2021-08-31,106,44,671,320,9,Wien,150,364,12.1
5179,76518104,2021-08-31,393,133,1625,718,10,Alle,526,851,15.6
5180,2797907,2021-09-01,10,1,102,34,1,Burgenland,11,35,2.9
5181,3557341,2021-09-01,19,8,217,46,2,Kärnten,27,54,14.8
5182,14818665,2021-09-01,74,28,60,99,3,Niederösterreich,102,127,22.0
5183,12490663,2021-09-01,70,26,180,49,4,Oberösterreich,96,75,34.7
5184,5240788,2021-09-01,29,5,50,44,5,Salzburg,34,49,10.2
5185,10867138,2021-09-01,55,14,123,36,6,Steiermark,69,50,28.0
5186,5868409,2021-09-01,25,7,127,21,7,Tirol,32,28,25.0
5187,4419510,2021-09-01,11,5,89,68,8,Vorarlberg,16,73,6.8
5188,16740110,2021-09-01,108,47,669,317,9,Wien,155,364,12.9
5189,76800531,2021-09-01,401,141,1617,714,10,Alle,542,855,16.5
5190,2805262,2021-09-02,11,1,101,34,1,Burgenland,12,35,2.9
5191,3686589,2021-09-02,23,7,214,46,2,Kärnten,30,53,13.2
5192,14872582,2021-09-02,59,28,75,89,3,Niederösterreich,87,117,23.9
5193,12549881,2021-09-02,73,25,177,50,4,Oberösterreich,98,75,33.3
5194,5266876,2021-09-02,26,5,53,44,5,Salzburg,31,49,10.2
5195,10908389,2021-09-02,55,15,123,37,6,Steiermark,70,52,28.8
5196,5875375,2021-09-02,28,7,125,21,7,Tirol,35,28,25.0
5197,4433126,2021-09-02,10,5,90,51,8,Vorarlberg,15,56,8.9
5198,16813682,2021-09-02,111,50,666,314,9,Wien,161,364,13.7
5199,77211762,2021-09-02,396,143,1624,686,10,Alle,539,829,17.2
5200,2811914,2021-09-03,11,1,102,34,1,Burgenland,12,35,2.9
5201,3687129,2021-09-03,25,8,213,45,2,Kärnten,33,53,15.1
5202,14919964,2021-09-03,55,27,79,98,3,Niederösterreich,82,125,21.6
5203,12603638,2021-09-03,68,28,182,45,4,Oberösterreich,96,73,38.4
5204,5293323,2021-09-03,24,9,59,40,5,Salzburg,33,49,18.4
5205,10948991,2021-09-03,60,15,132,37,6,Steiermark,75,52,28.8
5206,5882619,2021-09-03,27,7,126,19,7,Tirol,34,26,26.9
5207,4446862,2021-09-03,13,4,87,52,8,Vorarlberg,17,56,7.1
5208,16881522,2021-09-03,113,54,664,310,9,Wien,167,364,14.8
5209,77475962,2021-09-03,396,153,1644,680,10,Alle,549,833,18.4
5210,2825467,2021-09-04,13,0,98,35,1,Burgenland,13,35,0.0
5211,3701932,2021-09-04,22,7,215,45,2,Kärnten,29,52,13.5
5212,14963543,2021-09-04,58,27,76,101,3,Niederösterreich,85,128,21.1
5213,12676299,2021-09-04,71,27,179,48,4,Oberösterreich,98,75,36.0
5214,5326339,2021-09-04,22,11,59,40,5,Salzburg,33,51,21.6
5215,11010278,2021-09-04,54,16,130,36,6,Steiermark,70,52,30.8
5216,5893205,2021-09-04,24,7,125,19,7,Tirol,31,26,26.9
5217,4464368,2021-09-04,13,4,87,52,8,Vorarlberg,17,56,7.1
5218,16956910,2021-09-04,118,55,659,309,9,Wien,173,364,15.1
5219,77818341,2021-09-04,395,154,1628,685,10,Alle,549,839,18.4
5220,2835065,2021-09-05,11,0,101,35,1,Burgenland,11,35,0.0
5221,3702223,2021-09-05,17,7,220,46,2,Kärnten,24,53,13.2
5222,15032471,2021-09-05,54,29,80,114,3,Niederösterreich,83,143,20.3
5223,12755775,2021-09-05,73,27,177,48,4,Oberösterreich,100,75,36.0
5224,5362486,2021-09-05,25,11,59,40,5,Salzburg,36,51,21.6
5225,11070337,2021-09-05,58,16,126,36,6,Steiermark,74,52,30.8
5226,5901265,2021-09-05,26,8,124,16,7,Tirol,34,24,33.3
5227,4481532,2021-09-05,12,4,88,52,8,Vorarlberg,16,56,7.1
5228,17052586,2021-09-05,119,55,658,309,9,Wien,174,364,15.1
5229,78193740,2021-09-05,395,157,1633,696,10,Alle,552,853,18.4
5230,2844120,2021-09-06,12,1,100,34,1,Burgenland,13,35,2.9
5231,3703069,2021-09-06,23,8,214,45,2,Kärnten,31,53,15.1
5232,15097093,2021-09-06,57,29,77,108,3,Niederösterreich,86,137,21.2
5233,12830369,2021-09-06,83,28,167,47,4,Oberösterreich,111,75,37.3
5234,5388947,2021-09-06,24,10,59,39,5,Salzburg,34,49,20.4
5235,11112595,2021-09-06,61,16,123,36,6,Steiermark,77,52,30.8
5236,5908465,2021-09-06,29,6,122,19,7,Tirol,35,25,24.0
5237,4496658,2021-09-06,11,7,89,56,8,Vorarlberg,18,63,11.1
5238,17150535,2021-09-06,113,66,664,298,9,Wien,179,364,18.1
5239,78531851,2021-09-06,413,171,1615,682,10,Alle,584,853,20.0
